Adj DP,Qual DP,Alliance DP,Playoff DP,Qual Points,Alliance Points,Playoff Points,Total Points
82.49642410541063,24.470849397560006,22.802382393180917,35.2231923146697,17,15,0,32
37.54990460701995,22.77617164688095,14.773732960138997,0.0,14,3,20,37
40.01219343370978,19.69831061351866,14.158160753466538,6.155722066724581,21,15,0,36
17.23602178682883,12.927016340121622,4.309005446707207,0.0,20,14,20,54
44.121683004691526,24.5635420089144,14.92351042805743,4.634630567719698,22,16,5,43
11.0,11.0,0.0,0.0,8,0,0,8
46.902461345323346,22.802382393180917,14.830817816703034,9.269261135439397,17,16,5,38
58.65823112395241,26.60082574225749,20.689531132866936,11.367874248827986,9,2,0,11
38.0,17.0,11.0,10.0,15,0,0,15
35.13049970331531,18.445829659524396,2.780778340631819,13.903891703159093,12,0,0,12
17.851593993501286,12.311444133449163,5.540149860052123,0.0,13,0,0,13
16.0,13.0,3.0,0.0,18,13,10,41
29.547465920277993,16.00487737348391,1.2311444133449163,12.311444133449163,12,4,10,26
36.31876019367503,18.467166200173743,11.695871926776706,6.155722066724581,13,0,0,13
35.08761578033012,20.92945502686358,14.158160753466538,0.0,8,0,0,8
29.012787353925308,14.645432593994247,0.4634630567719698,13.903891703159093,10,0,0,10
58.95250082139456,28.827402131216523,19.928911441194703,10.196187248983335,11,1,5,17
41.06282682999652,21.133915388801825,10.659650305755305,9.269261135439397,5,0,0,5
53.11286630606774,22.9877676158897,13.440428646387124,16.684670043790913,10,0,0,10
23.0,15.0,8.0,0.0,7,0,0,7
13.0,13.0,0.0,0.0,9,0,0,9
30.6812543583044,20.021604052549097,10.659650305755305,0.0,14,0,0,14
24.0,10.0,4.0,10.0,12,0,0,12
16.0,16.0,0.0,0.0,6,0,0,6
44.81365664575495,23.268629412218917,9.233583100086872,12.311444133449163,16,0,0,16
8.0,8.0,0.0,0.0,4,0,0,4
32.0,16.0,6.0,10.0,15,0,0,15
46.78348770710682,19.082738406846204,15.389305166811454,12.311444133449163,16,14,20,50
28.316321506933075,17.851593993501286,10.46472751343179,0.0,19,13,10,42
35.70318798700257,16.62044958015637,12.927016340121622,6.155722066724581,11,0,0,11
77.13860536113043,28.900925631937017,23.228356381771853,25.00932334742157,18,10,20,48
57.115989517528085,21.341289256466407,5.725619329993029,30.049080931068644,10,11,15,36
25.854032680243243,11.695871926776706,8.002438686741955,6.155722066724581,9,0,0,9
40.01219343370978,23.39174385355341,16.62044958015637,0.0,12,0,0,12
22.895075004535308,17.33351832327167,5.561556681263638,0.0,12,0,0,12
27.08517709358816,15.389305166811454,5.540149860052123,6.155722066724581,11,0,0,11
49.03343092661138,24.70996932553577,16.744878768523623,7.578582832551991,5,13,15,33
43.092795018657746,21.982052782694527,16.476111668243526,4.634630567719698,13,9,30,52
36.93433240034749,19.082738406846204,11.695871926776706,6.155722066724581,3,5,0,8
10.46472751343179,10.46472751343179,0.0,0.0,14,11,15,40
28.316321506933075,16.62044958015637,5.540149860052123,6.155722066724581,12,1,5,18
19.082738406846204,13.542588546794079,5.540149860052123,0.0,11,0,0,11
21.545027233536036,16.00487737348391,5.540149860052123,0.0,9,0,0,9
15.389305166811454,14.773732960138997,0.6155722066724582,0.0,15,0,0,15
32.178240031677866,17.34742221497483,0.9269261135439396,13.903891703159093,14,15,5,34
24.007316060225868,17.851593993501286,6.155722066724581,0.0,14,0,0,14
31.515487860493945,20.39237449796667,11.123113362527276,0.0,16,0,0,16
28.931893713605536,17.23602178682883,11.695871926776706,0.0,20,0,0,20
35.11659581161215,15.187684370417449,6.025019738035607,13.903891703159093,13,0,0,13
64.87266904664504,25.539824145700212,20.386387819564856,18.94645708137998,14,14,5,33
95.22005768208658,35.43079451689717,25.00997260016271,34.779290565026685,22,16,5,43
8.618010893414414,8.618010893414414,0.0,0.0,13,0,0,13
67.06287948525258,29.245751150818137,12.807804987012863,25.00932334742157,17,10,20,47
102.25694862492657,36.50366918390778,25.78788776657524,39.965391674443524,22,16,5,43
24.007316060225868,14.773732960138997,3.0778610333622907,6.155722066724581,7,0,0,7
33.8564713669852,15.389305166811454,6.155722066724581,12.311444133449163,13,0,0,13
35.11659581161215,20.285777994909118,10.196187248983335,4.634630567719698,8,3,5,16
22.160599440208493,15.389305166811454,6.771294273397039,0.0,10,0,0,10
42.83415016958385,20.62890247020652,10.837373450549348,11.367874248827986,16,13,15,44
14.158160753466538,14.158160753466538,0.0,0.0,6,0,0,6
17.851593993501286,14.158160753466538,3.693433240034749,0.0,18,0,0,18
33.8564713669852,18.467166200173743,15.389305166811454,0.0,21,9,30,60
28.316321506933075,17.23602178682883,11.080299720104247,0.0,10,4,15,29
28.692514604041836,22.326505024698168,6.366009579343672,0.0,19,0,0,19
8.618010893414414,8.618010893414414,0.0,0.0,4,0,0,4
64.9257191264729,26.752397398908528,14.603929118327686,23.569392609236694,20,0,0,20
34.13868876182329,17.91748177480435,6.951945851579547,9.269261135439397,17,0,0,17
23.39174385355341,13.542588546794079,3.693433240034749,6.155722066724581,7,0,0,7
45.41937956365304,19.928911441194703,11.586576419299245,13.903891703159093,17,0,0,17
38.18935587801031,19.18737055035955,5.098093624491668,13.903891703159093,9,0,0,9
29.51100154995745,16.627410734619065,5.305007982786393,7.578582832551991,6,0,0,6
44.49007051849646,22.51218030409569,6.820724549296792,15.157165665103982,8,0,0,8
50.65651210517629,25.379236988833064,15.49820461845467,9.779070497888563,15,0,0,15
29.547465920277993,16.62044958015637,6.771294273397039,6.155722066724581,16,14,5,35
35.00999930855459,21.569570662167475,8.805798078667426,4.634630567719698,15,0,0,15
12.927016340121622,12.927016340121622,0.0,0.0,5,0,0,5
49.113180126125634,27.335051088410783,17.143498469995166,4.634630567719698,12,0,0,12
37.54990460701995,19.082738406846204,12.311444133449163,6.155722066724581,19,12,0,31
24.62288826689833,14.773732960138997,3.693433240034749,6.155722066724581,12,0,0,12
36.303061236948395,15.447223682209753,6.951945851579547,13.903891703159093,11,7,20,38
49.901178660938584,25.448881151709585,12.250779148820293,12.201518360408707,15,12,0,27
34.30066590013031,21.038145943164327,5.683937124413993,7.578582832551991,10,2,5,17
51.28048073646304,24.800912319526386,11.322402751832675,15.157165665103982,7,0,0,7
39.80220731557676,17.555980590522214,8.342335021895456,13.903891703159093,16,0,0,16
28.316321506933075,17.851593993501286,10.46472751343179,0.0,8,8,30,46
41.2435774221376,16.680035413223194,10.659650305755305,13.903891703159093,13,15,5,33
28.931893713605536,17.23602178682883,11.695871926776706,0.0,9,6,15,30
36.863851535642475,20.642644548623533,6.951945851579547,9.269261135439397,11,0,0,11
28.316321506933075,14.773732960138997,7.386866480069498,6.155722066724581,6,0,0,6
30.778610333622908,17.23602178682883,7.386866480069498,6.155722066724581,11,0,0,11
45.60476478636182,24.84161984297758,11.493883807944849,9.269261135439397,13,2,0,15
21.545027233536036,16.62044958015637,4.924577653379665,0.0,4,0,0,4
51.30700577637698,23.645178437562212,8.71537025743479,18.94645708137998,16,13,0,29
9.0,9.0,0.0,0.0,11,7,25,43
23.39174385355341,14.773732960138997,8.618010893414414,0.0,15,11,0,26
93.80492269064669,31.700873083202737,23.17315283859849,38.930896768845464,18,16,30,64
73.36068181910328,31.602690411741804,22.811534325981494,18.94645708137998,20,15,0,35
49.49785446324637,26.23200901329349,13.996584314513488,9.269261135439397,17,12,15,44
37.26242976446637,24.378156786205608,8.249642410541062,4.634630567719698,17,14,15,46
52.000554969815006,28.178553851735764,19.18737055035955,4.634630567719698,16,11,0,27
60.89904565983683,22.895075004535308,10.196187248983335,27.807783406318187,21,15,0,36
70.10189120110591,29.708044703603807,21.447389416122135,18.94645708137998,18,13,0,31
23.39174385355341,17.23602178682883,6.155722066724581,0.0,8,0,0,8
16.0,16.0,0.0,0.0,12,4,0,16
14.830817816703032,14.830817816703034,0.0,0.0,15,10,25,50
45.51207217500743,25.119697677040765,11.123113362527276,9.269261135439397,14,12,15,41
26.4696048869157,18.467166200173743,8.002438686741955,0.0,15,9,0,24
30.310483912886827,23.822001118079246,6.488482794807577,0.0,9,0,0,9
42.47448226039961,18.467166200173743,11.695871926776706,12.311444133449163,8,0,0,8
19.082738406846204,15.389305166811454,3.693433240034749,0.0,7,0,0,7
41.85891005372716,14.773732960138997,8.618010893414414,18.467166200173743,12,3,15,30
45.88284262042501,24.007386340788035,17.240825711917278,4.634630567719698,14,6,0,20
19.69831061351866,12.927016340121622,6.771294273397039,0.0,12,8,0,20
12.0,12.0,0.0,0.0,9,0,0,9
29.939713467469243,19.743526218485915,10.196187248983335,0.0,14,9,0,23
48.84900618376562,23.35853806130728,11.586576419299245,13.903891703159093,10,5,15,30
41.06282682999652,21.133915388801825,10.659650305755305,9.269261135439397,7,0,0,7
12.0,12.0,0.0,0.0,13,0,0,13
4.0,4.0,0.0,0.0,10,0,0,10
35.70318798700257,22.160599440208493,7.386866480069498,6.155722066724581,19,14,15,48
58.58173037597698,18.26044443681561,13.440428646387124,26.880857292774248,11,10,25,46
38.49920078936411,18.03702714147374,9.09429939906239,11.367874248827986,10,1,30,41
89.26298473428139,31.23741002643077,22.802382393180917,35.2231923146697,22,16,30,68
23.39174385355341,15.389305166811454,1.8467166200173746,6.155722066724581,5,0,0,5
32.00975474696782,17.851593993501286,8.002438686741955,6.155722066724581,18,12,0,30
46.78348770710682,19.082738406846204,15.389305166811454,12.311444133449163,17,11,0,28
75.72986347653986,25.675853345167127,20.39237449796667,29.661635633406068,14,13,30,57
9.84915530675933,9.84915530675933,0.0,0.0,16,12,0,28
31.14471741507637,17.889673991398034,7.6934867424146995,5.561556681263638,15,16,10,41
23.39174385355341,14.773732960138997,2.4622888266898326,6.155722066724581,15,9,0,24
34.38895881248016,18.167751825461217,6.951945851579547,9.269261135439397,12,7,5,24
53.761714585548496,21.690071056928186,11.67926903065364,20.39237449796667,22,16,10,48
10.46472751343179,10.46472751343179,0.0,0.0,10,0,0,10
5.0,5.0,0.0,0.0,7,0,0,7
11.0,11.0,0.0,0.0,7,2,20,29
11.695871926776706,11.695871926776706,0.0,0.0,11,0,0,11
11.080299720104247,11.080299720104247,0.0,0.0,16,10,5,31
14.0,8.0,6.0,0.0,5,0,0,5
19.465448384422732,19.465448384422732,0.0,0.0,9,0,0,9
12.311444133449164,12.311444133449163,0.0,0.0,21,15,20,56
32.62532695364028,15.389305166811454,4.924577653379665,12.311444133449163,8,0,0,8
26.0,13.0,3.0,10.0,11,8,0,19
40.04320810509819,18.72390749358758,12.050039476071214,9.269261135439397,19,13,30,62
33.46203269893622,20.485067109321065,3.7077044541757584,9.269261135439397,18,14,10,42
3.0,3.0,0.0,0.0,13,3,10,26
42.9166790570844,22.24622672505455,11.401191196590458,9.269261135439397,15,15,20,50
12.311444133449164,12.311444133449163,0.0,0.0,4,0,0,4
24.62288826689833,19.082738406846204,5.540149860052123,0.0,17,11,0,28
37.54990460701995,19.69831061351866,11.695871926776706,6.155722066724581,20,14,10,44
7.0,7.0,0.0,0.0,10,9,0,19
17.23602178682883,17.23602178682883,0.0,0.0,12,1,10,23
38.16547681369241,21.545027233536036,16.62044958015637,0.0,13,10,5,28
13.54258854679408,12.311444133449163,1.2311444133449163,0.0,14,5,0,19
38.78104902036487,16.00487737348391,16.62044958015637,6.155722066724581,13,4,30,47
19.082738406846204,13.542588546794079,5.540149860052123,0.0,10,0,0,10
82.49642410541063,24.470849397560006,22.802382393180917,35.2231923146697,15,16,30,61
43.75091255927395,19.65083360713152,10.196187248983335,13.903891703159093,12,0,0,12
75.72986347653986,25.675853345167127,20.39237449796667,29.661635633406068,21,15,0,36
75.35909303112228,23.822001118079246,21.875456279636975,29.661635633406068,20,14,25,59
78.13987137175411,29.84702085611486,23.265845449952884,25.02700506568637,14,12,15,41
45.512072175007425,25.397775511103944,15.479666096183792,4.634630567719698,13,10,15,38
106.25173131237891,33.800479433181884,24.70618003411949,47.74507184507755,17,9,0,26
38.18935587801031,19.280063161713944,13.34773603503273,5.561556681263638,18,11,5,34
31.14471741507637,17.889673991398034,7.6934867424146995,5.561556681263638,11,0,0,11
34.38895881248016,18.167751825461217,6.951945851579547,9.269261135439397,9,0,0,9
69.14868807037789,25.861238567875915,20.114296663903488,23.17315283859849,8,0,0,8
32.257028751329095,17.426210934626067,0.9269261135439396,13.903891703159093,14,0,0,14
100.84956115358064,32.62779919674668,23.729308506724855,44.4924534501091,22,16,30,68
53.201651484514976,24.93353751909605,16.900239716590942,11.367874248827986,15,6,5,26
73.36068181910328,31.602690411741804,22.811534325981494,18.94645708137998,16,14,25,55
37.26242976446637,24.378156786205608,8.249642410541062,4.634630567719698,8,8,0,16
52.000554969815006,28.178553851735764,19.18737055035955,4.634630567719698,16,9,0,25
11.080299720104247,11.080299720104247,0.0,0.0,11,0,0,11
60.89904565983683,22.895075004535308,10.196187248983335,27.807783406318187,5,2,0,7
70.10189120110591,29.708044703603807,21.447389416122135,18.94645708137998,12,0,0,12
40.04320810509819,18.72390749358758,12.050039476071214,9.269261135439397,6,0,0,6
47.36592440209531,18.631214882233188,0.9269261135439396,27.807783406318187,11,7,15,33
28.419685622069967,18.18859879812478,6.441795407669193,3.7892914162759954,18,10,15,43
33.46203269893622,20.485067109321065,3.7077044541757584,9.269261135439397,12,3,25,40
42.9166790570844,22.24622672505455,11.401191196590458,9.269261135439397,12,0,0,12
57.28403381701546,24.841619842977583,13.903891703159093,18.538522270878794,19,13,0,32
53.85440719690288,23.35853806130728,15.665051318892578,14.830817816703034,13,13,0,26
36.37719759624956,20.462173647890374,8.33644111580719,7.578582832551991,9,0,0,9
92.1364556862676,30.12509869017804,22.153534113700154,39.85782288238941,10,5,15,30
31.978950917265916,22.70968978182652,4.634630567719698,4.634630567719698,9,0,0,9
37.54990460701995,19.69831061351866,11.695871926776706,6.155722066724581,16,0,0,16
21.545027233536036,18.467166200173743,3.0778610333622907,0.0,6,0,0,6
58.58173037597698,18.26044443681561,13.440428646387124,26.880857292774248,7,1,30,38
52.92748108335894,26.139316401939098,12.884272978260759,13.903891703159093,10,0,0,10
54.132485030966066,19.65083360713152,19.65083360713152,14.830817816703034,17,11,5,33
24.62288826689833,17.23602178682883,7.386866480069498,0.0,7,0,0,7
38.78104902036487,16.00487737348391,16.62044958015637,6.155722066724581,13,4,0,17
38.49920078936411,18.03702714147374,9.09429939906239,11.367874248827986,4,0,0,4
80.45718665561397,32.16433613997471,23.265845449952884,25.02700506568637,14,15,0,29
89.26298473428139,31.23741002643077,22.802382393180917,35.2231923146697,19,12,15,46
42.091449051993756,22.38713368735858,8.33644111580719,11.367874248827986,6,7,0,13
21.545027233536036,16.00487737348391,5.540149860052123,0.0,15,3,0,18
26.4696048869157,16.62044958015637,9.84915530675933,0.0,16,10,0,26
18.467166200173747,11.695871926776706,6.771294273397039,0.0,15,9,0,24
11.695871926776706,11.695871926776706,0.0,0.0,9,0,0,9
32.178240031677866,17.34742221497483,0.9269261135439396,13.903891703159093,13,6,15,34
29.547465920277993,16.00487737348391,1.2311444133449163,12.311444133449163,11,0,0,11
28.931893713605536,17.23602178682883,11.695871926776706,0.0,12,1,30,43
59.010635225666086,26.358311091615825,18.25301675220147,14.399307381848782,8,12,5,25
31.602690411741804,16.06659560501022,7.9575119741795906,7.578582832551991,12,0,0,12
35.11659581161215,15.187684370417449,6.025019738035607,13.903891703159093,18,14,0,32
95.22005768208658,35.43079451689717,25.00997260016271,34.779290565026685,22,16,30,68
41.216122734834,20.753949086943624,5.305007982786393,15.157165665103982,13,10,0,23
24.007316060225868,14.773732960138997,9.233583100086872,0.0,7,0,0,7
36.84076575601988,22.903119024462118,10.696333538172233,3.241313193385525,15,13,10,38
102.25694862492657,36.50366918390778,25.78788776657524,39.965391674443524,17,12,5,34
19.69831061351866,14.773732960138997,4.924577653379665,0.0,7,4,10,21
33.8564713669852,15.389305166811454,6.155722066724581,12.311444133449163,10,8,0,18
56.26919703717271,28.24480316716146,18.30045428985467,9.723939580156575,21,15,20,56
49.31246924053759,19.18737055035955,11.586576419299245,18.538522270878794,14,9,0,23
22.160599440208493,15.389305166811454,6.771294273397039,0.0,4,0,0,4
16.62044958015637,16.62044958015637,0.0,0.0,18,13,10,41
19.082738406846204,14.773732960138997,4.309005446707207,0.0,10,0,0,10
30.778610333622908,17.23602178682883,1.2311444133449163,12.311444133449163,19,14,0,33
11.95734686471682,11.957346864716822,0.0,0.0,13,0,0,13
22.776171646880954,17.23602178682883,5.540149860052123,0.0,11,0,0,11
41.859983287644305,17.29644127872991,10.659650305755305,13.903891703159093,9,2,20,31
64.9257191264729,26.752397398908528,14.603929118327686,23.569392609236694,5,5,5,15
45.41937956365304,19.928911441194703,11.586576419299245,13.903891703159093,16,11,15,42
27.08517709358816,17.851593993501286,9.233583100086872,0.0,17,11,15,43
14.158160753466538,14.158160753466538,0.0,0.0,8,0,0,8
72.37925534228778,20.64405963587162,23.27761717018344,28.457578536232724,14,16,30,60
6.155722066724582,6.155722066724581,0.0,0.0,12,0,0,12
9.84915530675933,9.84915530675933,0.0,0.0,10,0,0,10
36.863851535642475,20.642644548623533,6.951945851579547,9.269261135439397,20,15,20,55
26.4696048869157,13.542588546794079,6.771294273397039,6.155722066724581,7,1,5,13
18.467166200173747,17.851593993501286,0.6155722066724582,0.0,11,0,0,11
76.74948220143821,29.84702085611486,23.729308506724855,23.17315283859849,22,16,30,68
58.859808210040164,23.63661589537046,12.050039476071214,23.17315283859849,15,9,0,24
25.854032680243243,15.389305166811454,4.309005446707207,6.155722066724581,18,11,0,29
60.71366043712804,30.495869135595612,20.021604052549097,10.196187248983335,10,15,0,25
15.0,15.0,0.0,0.0,11,5,10,26
13.54258854679408,13.542588546794079,0.0,0.0,11,0,0,11
31.0,19.0,12.0,0.0,5,0,0,5
30.778610333622908,18.467166200173743,12.311444133449163,0.0,19,12,10,41
12.0,12.0,0.0,0.0,14,0,0,14
11.080299720104247,11.080299720104247,0.0,0.0,4,0,0,4
7.0,7.0,0.0,0.0,6,0,0,6
65.44098361620213,24.934312454331973,16.40659220972773,24.10007895214243,11,4,0,15
28.193207065598582,21.421912792201542,6.771294273397039,0.0,12,0,0,12
17.0,12.0,5.0,0.0,7,0,0,7
41.71167510947728,22.24622672505455,10.196187248983335,9.269261135439397,8,0,25,33
15.0,15.0,0.0,0.0,17,10,10,37
96.85428860001446,35.0130526863902,25.46403831737469,36.37719759624956,17,16,30,63
61.64058655067198,26.232009013293492,16.8700552664997,18.538522270878794,13,8,0,21
44.0,20.0,14.0,10.0,6,0,0,6
8.0,8.0,0.0,0.0,9,0,0,9
48.65450178498377,24.47882254914293,12.807804987012863,11.367874248827986,15,12,10,37
11.0,11.0,0.0,0.0,12,0,0,12
52.27863280387819,24.934312454331973,13.440428646387124,13.903891703159093,21,15,0,36
10.0,8.0,2.0,0.0,14,0,0,14
63.963239106738804,29.101758076999644,15.915023948359181,18.94645708137998,18,13,0,31
27.700749300260618,17.23602178682883,4.309005446707207,6.155722066724581,14,0,0,14
11.0,11.0,0.0,0.0,17,11,0,28
48.84900618376561,27.6223981836094,16.59197743243652,4.634630567719698,13,2,0,15
62.75289788692471,20.57775972067546,22.70968978182652,19.465448384422732,10,7,10,27
42.47448226039961,20.92945502686358,15.389305166811454,6.155722066724581,15,0,0,15
10.0,10.0,0.0,0.0,13,0,0,13
33.8564713669852,19.082738406846204,14.773732960138997,0.0,9,0,0,9
36.798966707694404,18.72390749358758,8.805798078667426,9.269261135439397,21,14,20,55
22.060841502345763,16.499284821082124,5.561556681263638,0.0,10,0,0,10
24.007316060225868,14.158160753466538,9.84915530675933,0.0,16,6,0,22
16.0,16.0,0.0,0.0,16,9,0,25
15.389305166811454,15.389305166811454,0.0,0.0,4,0,0,4
40.01219343370978,23.39174385355341,16.62044958015637,0.0,20,13,0,33
46.99515395667774,24.74892723162319,8.342335021895456,13.903891703159093,19,14,20,53
19.69831061351866,12.311444133449163,1.2311444133449163,6.155722066724581,12,0,0,12
6.0,6.0,0.0,0.0,8,0,0,8
14.0,14.0,0.0,0.0,8,0,0,8
23.0,10.0,3.0,10.0,15,0,0,15
23.17315283859849,20.39237449796667,2.780778340631819,0.0,12,3,20,35
14.645432593994245,14.645432593994247,0.0,0.0,14,0,0,14
32.62532695364028,19.69831061351866,0.6155722066724582,12.311444133449163,10,0,0,10
34.083073195010655,21.106107605395504,8.342335021895456,4.634630567719698,8,0,20,28
54.40664615489074,25.28215232939344,13.133684048812599,15.990809776684703,17,0,30,47
88.01766101725882,28.08622797743768,19.272336143179714,40.65909689664143,22,0,30,52
71.76917942426735,28.639464524213974,19.977144346607048,23.152570553446335,21,0,20,41
65.12276228011925,31.1138718190422,18.434902740182718,15.573987720894342,8,0,5,13
10.46472751343179,10.46472751343179,0.0,0.0,11,0,0,11
22.776171646880954,16.62044958015637,6.155722066724581,0.0,4,0,0,4
43.54653695584374,24.221150732836165,7.9575119741795906,11.367874248827986,16,0,5,21
49.946650157933895,23.42161024400193,11.367874248827986,15.157165665103982,9,0,5,14
33.24089916031274,17.851593993501286,9.233583100086872,6.155722066724581,15,0,10,25
11.080299720104247,11.080299720104247,0.0,0.0,13,0,10,23
16.62044958015637,9.233583100086872,1.2311444133449163,6.155722066724581,12,0,0,12
28.931893713605536,18.467166200173743,10.46472751343179,0.0,12,0,5,17
12.311444133449164,12.311444133449163,0.0,0.0,9,0,0,9
24.007316060225868,16.00487737348391,8.002438686741955,0.0,5,0,0,5
42.425408216906106,19.252255378307627,9.269261135439397,13.903891703159093,17,0,0,17
62.04585765010315,29.556473046952764,16.498574826465685,15.990809776684703,16,0,5,21
36.608946854417894,20.387739867398952,11.586576419299245,4.634630567719698,10,0,0,10
35.08761578033012,15.389305166811454,7.386866480069498,12.311444133449163,15,0,10,25
27.08517709358816,19.082738406846204,8.002438686741955,0.0,19,0,10,29
14.773732960138997,14.773732960138997,0.0,0.0,13,0,10,23
30.22242593210015,20.489701739888787,9.732724192211366,0.0,18,0,0,18
11.695871926776706,11.695871926776706,0.0,0.0,14,0,5,19
49.147109669099656,24.691022868454386,12.671390496026929,11.784696304618347,20,0,10,30
21.545027233536036,11.695871926776706,9.84915530675933,0.0,10,0,20,30
33.8564713669852,20.313882820191118,13.542588546794079,0.0,11,0,0,11
38.83820415749106,24.5635420089144,14.274662148576668,0.0,14,13,10,37
50.094432523168656,21.295817759471095,6.062866266041593,22.735748497655972,4,1,25,30
45.697457397716214,21.31930061151061,10.474265083046518,13.903891703159093,19,15,20,54
14.773732960138997,14.773732960138997,0.0,0.0,7,7,5,19
75.1737078084135,27.807783406318187,19.558140995777126,27.807783406318187,15,0,0,15
31.714776974905895,17.143498469995166,9.936647937191031,4.634630567719698,12,11,10,33
15.850436541601368,15.850436541601368,0.0,0.0,11,0,5,16
23.080460227244092,17.055440489208486,1.3903891703159095,4.634630567719698,11,0,5,16
19.465448384422732,17.148133100562884,2.317315283859849,0.0,14,5,5,24
17.23602178682883,12.927016340121622,4.309005446707207,0.0,18,13,10,41
73.31985558132561,28.827402131216523,20.39237449796667,24.10007895214243,20,16,30,66
34.47204357365766,20.313882820191118,14.158160753466538,0.0,12,12,5,29
53.947099808257285,21.875456279636975,7.97156457647788,24.10007895214243,15,14,0,29
21.545027233536036,16.62044958015637,4.924577653379665,0.0,15,9,0,24
26.139316401939094,16.40659220972773,9.732724192211366,0.0,13,3,0,16
83.06126784476982,24.25146506416637,23.94832175086429,34.86148102973916,22,16,30,68
26.4696048869157,16.62044958015637,9.84915530675933,0.0,9,6,10,25
12.311444133449164,12.311444133449163,0.0,0.0,7,0,5,12
20.92945502686358,11.695871926776706,3.0778610333622907,6.155722066724581,16,10,5,31
28.931893713605536,12.311444133449163,4.309005446707207,12.311444133449163,18,14,0,32
19.280063161713944,9.083875912730608,0.9269261135439396,9.269261135439397,10,10,0,20
12.927016340121622,12.927016340121622,0.0,0.0,17,11,5,33
37.544299352462566,23.444345992499585,10.310661943686984,3.7892914162759954,21,15,20,56
36.91946710245511,20.2347970586642,12.050039476071214,4.634630567719698,13,4,10,27
40.32128593916137,22.24622672505455,13.440428646387124,4.634630567719698,12,0,0,12
21.545027233536036,16.62044958015637,4.924577653379665,0.0,9,0,0,9
24.62288826689833,11.695871926776706,0.6155722066724582,12.311444133449163,17,12,5,34
34.481651423834556,20.114296663903488,0.4634630567719698,13.903891703159093,6,8,0,14
9.233583100086873,9.233583100086872,0.0,0.0,16,9,0,25
48.6302043271242,19.69831061351866,16.62044958015637,12.311444133449163,14,2,20,36
57.37672642836986,25.861238567875915,12.976965589615155,18.538522270878794,8,0,0,8
11.0,11.0,0.0,0.0,11,0,0,11
30.16303812695045,19.69831061351866,10.46472751343179,0.0,10,0,0,10
13.050130781456113,13.050130781456112,0.0,0.0,10,0,0,10
10.0,10.0,0.0,0.0,5,0,0,5
45.975535231779396,21.041222777447427,15.665051318892578,9.269261135439397,8,0,0,8
61.750292919633615,26.036221321232365,20.556905933297276,15.157165665103982,14,15,10,39
49.266122934860384,20.23016242809648,19.76669937132451,9.269261135439397,22,16,25,63
68.82868928523719,26.604615033673767,23.27761717018344,18.94645708137998,18,16,25,59
45.55841848068464,21.004145732905673,10.140571682170698,14.413701065608262,4,8,0,12
48.227965687691174,17.50036502370958,11.169459668204473,19.558140995777126,8,0,0,8
72.3493517895583,28.150805084553284,21.509354351306342,22.689192353698676,13,11,30,54
31.523115292000004,16.80171813976776,2.1030567360331776,12.618340416199064,12,9,0,21
19.082738406846204,14.158160753466538,4.924577653379665,0.0,10,3,0,13
5.0,5.0,0.0,0.0,14,10,0,24
11.080299720104247,11.080299720104247,0.0,0.0,7,4,5,16
46.33457209944608,22.089549412922356,11.279769912981626,12.9652527735421,21,15,10,46
32.08014113019257,17.976398478813323,14.103742651379255,0.0,13,10,0,23
26.4696048869157,16.62044958015637,9.84915530675933,0.0,17,13,5,35
61.60629984581513,26.72966165041087,18.54479219125472,16.33184600414954,15,12,15,42
19.873295874382062,10.140571682170698,0.4634630567719698,9.269261135439397,12,9,0,21
37.544299352462566,23.444345992499585,10.310661943686984,3.7892914162759954,9,12,15,36
7.9715645764778795,7.97156457647788,0.0,0.0,16,14,0,30
36.91946710245511,20.2347970586642,12.050039476071214,4.634630567719698,10,7,0,17
48.87428068712779,21.60275036418945,7.491429129977643,19.780101192960696,11,5,15,31
41.438231905981816,20.540682676133702,15.753109299679254,5.144439930168865,11,6,30,47
42.56908176450542,21.20806947788534,11.581941788731527,9.779070497888563,19,14,0,33
25.949296548662588,17.143498469995166,8.805798078667426,0.0,8,1,25,34
37.63524234645318,20.42049144231134,9.636168071589857,7.578582832551991,17,13,5,35
61.750292919633615,26.036221321232365,20.556905933297276,15.157165665103982,9,0,0,9
49.266122934860384,20.23016242809648,19.76669937132451,9.269261135439397,14,0,0,14
51.29053997213256,20.154485436471195,17.10116840830203,14.034886127359322,17,0,0,17
59.567661063858644,26.104428566725332,16.373528209728576,17.08970428740474,10,0,0,10
89.90851743398055,32.822842247782674,25.255627289479513,31.830047896718362,20,13,10,43
95.33857203350405,34.255194403135,24.70618003411949,36.37719759624956,17,16,20,53
87.22323318622153,34.63481015538971,24.88628080605143,27.702142224780395,19,11,0,30
76.31632912379854,32.05740538169492,21.523175244447653,22.735748497655972,3,0,0,3
69.73054064231086,29.817934154675807,20.549327350464722,19.363279137170338,6,0,0,6
44.3997608387547,17.055440489208486,8.805798078667426,18.538522270878794,4,0,0,4
76.74948220143821,29.84702085611486,23.729308506724855,23.17315283859849,21,14,30,65
42.39838165671211,21.56864674144297,10.977577232951559,9.85215768231759,6,0,0,6
45.697457397716214,21.31930061151061,10.474265083046518,13.903891703159093,8,0,0,8
45.5469329934534,24.6988065335977,15.662025350438856,5.18610110941684,15,0,0,15
58.859808210040164,23.63661589537046,12.050039476071214,23.17315283859849,7,0,0,7
59.48050736128431,27.91570986370526,15.573987720894342,15.990809776684703,7,0,0,7
75.1737078084135,27.807783406318187,19.558140995777126,27.807783406318187,13,0,10,23
80.78769299500422,26.426518337108792,22.79637716031639,31.564797497579043,8,8,0,16
65.44098361620213,24.934312454331973,16.40659220972773,24.10007895214243,12,0,0,12
91.86379180477896,33.04262114992668,23.1260455135324,35.69512514131988,9,4,10,23
50.230692064472585,21.052569468198072,10.710956396100771,18.467166200173743,5,0,0,5
95.22005768208658,35.43079451689717,25.00997260016271,34.779290565026685,20,14,30,64
61.64058655067198,26.232009013293492,16.8700552664997,18.538522270878794,15,0,0,15
103.47796999566488,35.930061209128986,26.130953606639263,41.41695517989663,17,15,10,42
97.4605752266186,33.42155029155428,23.872535922538773,40.16648901252555,19,13,10,42
65.7631525294699,22.872162988641907,11.74301409903931,31.147975441788684,11,0,0,11
102.25694862492657,36.50366918390778,25.78788776657524,39.965391674443524,14,6,0,20
61.45520132796319,24.285464174851217,16.777362655145307,20.39237449796667,15,0,0,15
77.97951280646896,32.80857214344828,25.00997260016271,20.160968062857965,14,0,0,14
53.947099808257285,21.875456279636975,7.97156457647788,24.10007895214243,13,0,0,13
70.86732806719365,31.890676559378775,25.676238636686143,13.300412871128746,18,10,0,28
83.97594221423219,31.25274181062323,25.07479886403042,27.648401539578526,22,15,0,37
72.3493517895583,28.150805084553284,21.509354351306342,22.689192353698676,13,0,0,13
83.06126784476982,24.25146506416637,23.94832175086429,34.86148102973916,16,12,5,33
53.35322314116602,18.719099596403417,14.171949896872222,20.462173647890374,10,0,0,10
72.02215902236411,31.700873083202737,21.78276366828258,18.538522270878794,16,11,0,27
76.23568630842755,25.946712113051127,22.64057265579789,27.648401539578526,15,3,30,48
50.42478057679031,25.861238567875915,12.513502532843185,12.050039476071214,12,0,0,12
106.67992124241809,31.974040970536848,25.71034225943263,48.99553801244863,22,16,20,58
59.41596387816652,20.948530166093036,19.928911441194703,18.538522270878794,11,0,0,11
71.76917942426735,28.639464524213974,19.977144346607048,23.152570553446335,16,0,0,16
48.57871595665826,22.197669116544784,9.97341500763842,16.407631832475058,10,0,0,10
100.1176819172921,35.59610148975983,27.149239307797153,37.372341119735104,19,12,5,36
68.03637673412517,25.02700506568637,19.836218829840305,23.17315283859849,12,2,10,24
75.5357350920457,27.73761316714029,18.99950716120784,28.798614763697564,11,1,20,32
72.83018102082463,30.086973845231405,23.79675009421325,18.94645708137998,13,0,0,13
91.81453101636737,31.326072138353656,24.03547545343864,36.45298342457508,14,0,0,14
68.49983979089714,27.715090794963793,16.684670043790913,24.10007895214243,11,0,0,11
92.02673133567883,24.89943389634957,18.131759426880638,48.99553801244863,18,7,0,25
63.58430996511121,24.17567923584085,20.462173647890374,18.94645708137998,12,10,0,22
58.11826731920501,24.74892723162319,14.830817816703034,18.538522270878794,17,0,0,17
82.25480490854447,27.654884165965296,21.83024435745151,32.76967638512765,10,0,0,10
72.67100730184487,27.437012960900613,21.133915388801825,24.10007895214243,8,0,0,8
89.49913989576113,30.526687655304876,20.660130294639337,38.312321945816905,16,0,0,16
77.58371570362775,29.661635633406068,19.18737055035955,28.73470951986213,15,0,0,15
59.972119546292895,25.95393117923031,14.552739982639851,19.465448384422732,9,0,0,9
61.60629984581513,26.72966165041087,18.54479219125472,16.33184600414954,18,9,0,27
56.82057076024349,21.875456279636975,20.114296663903488,14.830817816703034,7,0,0,7
79.3212372169054,31.345018595435036,19.442854256912135,28.533364364558246,12,5,5,22
73.20911016245222,25.615609974025727,16.52131057496334,31.072189613463163,12,0,0,12
64.80446180115207,28.60536090146749,20.625113178790244,15.573987720894342,13,0,0,13
65.93479297984837,26.06988201439978,19.703942902590605,20.160968062857965,8,0,0,8
57.07430731194904,24.111261281764158,14.016588948804909,18.94645708137998,10,0,0,10
68.40467363320812,28.202666095647448,23.99544157063304,16.206565966927624,14,9,0,23
61.462306771996644,23.26624929593461,18.491742111426856,19.70431536463518,6,0,0,6
88.21091487948891,31.898255142211333,22.891109445723288,33.42155029155428,5,0,0,5
61.93596819903114,27.597409384738075,21.720218398094005,12.618340416199064,11,0,0,11
84.67282455081006,27.57385133613066,20.731439184893816,36.36753402978559,9,0,0,9
59.567661063858644,26.104428566725332,16.373528209728576,17.08970428740474,5,11,5,21
26.61598290792259,13.732392092584206,5.305007982786393,7.578582832551991,15,9,0,24
34.44457437929279,21.004145732905673,8.805798078667426,4.634630567719698,12,0,0,12
53.0340775864165,20.591663612378618,9.269261135439397,23.17315283859849,11,0,5,16
43.031193323230205,22.44397305860272,13.008637432075492,7.578582832551991,9,4,10,23
56.20277028620556,25.683817219518698,15.361787401582886,15.157165665103982,16,14,10,40
91.86379180477896,33.04262114992668,23.1260455135324,35.69512514131988,18,14,10,42
39.13018588325741,23.372441953010437,11.123113362527276,4.634630567719698,14,3,5,22
14.158160753466538,13.542588546794079,0.6155722066724582,0.0,4,0,0,4
7.415408908351516,7.415408908351517,0.0,0.0,8,0,5,13
76.47169007186586,26.290103846122854,18.275752500699127,31.905833725043884,20,15,20,55
43.15245064855103,27.199533786029097,12.163625446245947,3.7892914162759954,22,16,25,63
20.85583755473864,18.075059214106822,2.780778340631819,0.0,9,0,0,9
28.577132080559654,15.136703434172532,8.805798078667426,4.634630567719698,8,13,10,31
11.695871926776706,11.695871926776706,0.0,0.0,17,13,10,40
41.704941327533604,23.141202679197505,10.985155815784111,7.578582832551991,16,11,5,32
92.02673133567883,24.89943389634957,18.131759426880638,48.99553801244863,19,16,30,65
14.158160753466538,14.158160753466538,0.0,0.0,10,5,0,15
42.990833146167915,22.598458648201248,6.488482794807577,13.903891703159093,13,12,5,30
46.1573587416579,15.979441902435873,14.187107062537326,15.990809776684703,14,9,0,23
30.12046405961032,19.460813753855014,6.025019738035607,4.634630567719698,7,0,0,7
21.5951717813569,17.805880365080903,3.7892914162759954,0.0,10,0,5,15
50.925320678104036,20.800221987926,11.586576419299245,18.538522270878794,12,10,0,22
45.05324374880318,20.953164796660754,10.196187248983335,13.903891703159093,13,7,0,20
9.233583100086873,9.233583100086872,0.0,0.0,17,12,5,34
28.266611832522436,15.753109299679254,7.878871965123487,4.634630567719698,15,2,20,37
36.794019652039914,20.500066562053135,12.504661673710785,3.7892914162759954,10,1,30,41
44.640761628276124,20.07721961936173,10.659650305755305,13.903891703159093,12,8,0,20
42.26783077760364,18.172386456028935,14.826183186135315,9.269261135439397,21,15,20,56
20.31388282019112,12.311444133449163,1.8467166200173746,6.155722066724581,6,0,0,6
28.316321506933075,15.389305166811454,6.771294273397039,6.155722066724581,8,0,0,8
30.778610333622908,16.00487737348391,8.618010893414414,6.155722066724581,10,0,0,10
35.63103980462903,19.409832817610095,6.951945851579547,9.269261135439397,10,0,0,10
70.86732806719365,31.890676559378775,25.676238636686143,13.300412871128746,15,0,0,15
42.61058197602356,25.733078007930285,13.088212551817287,3.7892914162759954,20,0,0,20
43.709476486743604,21.989258088649603,10.35234414926602,11.367874248827986,6,0,0,6
43.15245064855103,27.199533786029097,12.163625446245947,3.7892914162759954,17,0,0,17
9.233583100086873,9.233583100086872,0.0,0.0,5,0,0,5
43.403315266694975,19.76669937132451,5.098093624491668,18.538522270878794,17,0,0,17
26.4696048869157,17.23602178682883,9.233583100086872,0.0,19,0,0,19
16.62044958015637,12.927016340121622,3.693433240034749,0.0,9,0,0,9
11.695871926776706,11.695871926776706,0.0,0.0,13,0,0,13
48.07852948970983,27.29047678001972,16.581939237623757,4.206113472066355,13,0,0,13
92.02673133567883,24.89943389634957,18.131759426880638,48.99553801244863,15,0,0,15
45.28203242449815,24.06200049335257,9.85215768231759,11.367874248827986,12,0,0,12
33.8564713669852,18.467166200173743,15.389305166811454,0.0,16,0,0,16
48.0368472841308,24.126418447429263,12.542554587873546,11.367874248827986,14,0,0,14
46.1573587416579,15.979441902435873,14.187107062537326,15.990809776684703,11,0,0,11
30.778610333622908,19.69831061351866,11.080299720104247,0.0,12,0,0,12
41.13698091908004,22.343553966976664,14.158796384383677,4.634630567719698,11,0,0,11
7.386866480069498,7.386866480069498,0.0,0.0,8,0,0,8
9.233583100086873,9.233583100086872,0.0,0.0,10,0,0,10
28.266611832522436,15.753109299679254,7.878871965123487,4.634630567719698,7,0,0,7
31.39418254029537,17.23602178682883,14.158160753466538,0.0,21,0,0,21
42.26783077760364,18.172386456028935,14.826183186135315,9.269261135439397,22,0,0,22
31.770392541718525,15.549185554699585,6.951945851579547,9.269261135439397,18,0,0,18
29.346480754801128,16.832978221957944,7.878871965123487,4.634630567719698,4,0,0,4
25.854032680243243,14.158160753466538,5.540149860052123,6.155722066724581,14,0,0,14
24.62288826689833,16.00487737348391,2.4622888266898326,6.155722066724581,15,0,0,15
77.13860536113043,28.900925631937017,23.228356381771853,25.00932334742157,20,16,30,66
42.091449051993756,22.38713368735858,8.33644111580719,11.367874248827986,17,13,10,40
49.03343092661138,24.70996932553577,16.744878768523623,7.578582832551991,8,8,0,16
43.092795018657746,21.982052782694527,16.476111668243526,4.634630567719698,17,14,20,51
21.545027233536036,16.00487737348391,5.540149860052123,0.0,12,4,10,26
33.8564713669852,18.467166200173743,15.389305166811454,0.0,12,6,5,23
28.316321506933075,17.23602178682883,11.080299720104247,0.0,16,12,5,33
16.00487737348391,16.00487737348391,0.0,0.0,15,11,5,31
34.13868876182329,17.91748177480435,6.951945851579547,9.269261135439397,10,7,0,17
45.41937956365304,19.928911441194703,11.586576419299245,13.903891703159093,14,10,0,24
50.65651210517629,25.379236988833064,15.49820461845467,9.779070497888563,19,15,15,49
37.99933602473381,18.070424583539104,6.025019738035607,13.903891703159093,18,15,15,48
20.31388282019112,12.311444133449163,1.8467166200173746,6.155722066724581,11,10,0,21
36.303061236948395,15.447223682209753,6.951945851579547,13.903891703159093,13,9,0,22
90.50394698571064,32.95443123715063,26.076364640786544,31.473151107773447,22,16,30,68
42.272465408171364,21.416627853432725,11.586576419299245,9.269261135439397,15,13,10,38
12.927016340121622,11.695871926776706,1.2311444133449163,0.0,6,2,15,23
9.233583100086873,9.233583100086872,0.0,0.0,10,5,5,20
48.76060194463951,25.229102249565578,12.163625446245947,11.367874248827986,9,9,0,18
41.11381186659455,25.952856910074292,11.371663540244262,3.7892914162759954,14,12,5,31
28.931893713605536,17.23602178682883,11.695871926776706,0.0,11,11,5,27
60.03753319947687,26.786501021655013,20.708477589948316,12.542554587873546,20,15,25,60
52.41347886992956,23.406453078336824,17.639151542764758,11.367874248827986,7,7,5,19
15.389305166811454,12.927016340121622,2.4622888266898326,0.0,12,12,5,29
40.37055582361672,22.543333259996324,14.585909370234862,3.241313193385525,13,10,5,28
71.76917942426735,28.639464524213974,19.977144346607048,23.152570553446335,18,13,30,61
59.84436548947695,23.70048207003496,18.93251036256485,17.21137305687714,15,13,30,58
47.45329640602429,28.83271838644405,18.620578019580243,0.0,11,15,25,51
81.0620016533786,29.871942390240996,24.254746626103884,26.93531263703371,10,16,0,26
35.39956041085035,23.360981581341512,12.038578829508838,0.0,6,14,0,20
67.80936989425894,27.33594827701503,21.526964535863932,18.94645708137998,15,11,10,36
36.91946710245511,16.52709260448844,6.488482794807577,13.903891703159093,9,5,5,19
22.160599440208493,14.158160753466538,1.8467166200173746,6.155722066724581,17,12,5,34
57.65027960722299,29.632258875278286,20.43943789939272,7.578582832551991,8,3,0,11
19.69831061351866,10.46472751343179,3.0778610333622907,6.155722066724581,19,14,0,33
32.33581747098033,18.431925767821237,9.269261135439397,4.634630567719698,12,6,10,28
40.10809293304626,21.106107605395504,5.098093624491668,13.903891703159093,22,16,0,38
39.63219892283064,18.033237850057464,6.441795407669193,15.157165665103982,16,11,10,37
11.080299720104247,11.080299720104247,0.0,0.0,5,2,25,32
12.927016340121622,9.84915530675933,3.0778610333622907,0.0,10,4,30,44
30.16303812695045,15.389305166811454,8.618010893414414,6.155722066724581,14,10,5,29
49.760974878536366,20.96236011483881,6.062866266041593,22.735748497655972,13,1,0,14
51.29053997213256,20.154485436471195,17.10116840830203,14.034886127359322,8,3,30,41
45.26180212435057,19.30787094512026,12.050039476071214,13.903891703159093,11,0,0,11
69.73054064231086,29.817934154675807,20.549327350464722,19.363279137170338,12,9,5,26
54.40664615489074,25.28215232939344,13.133684048812599,15.990809776684703,12,8,5,25
52.41347886992956,23.406453078336824,17.639151542764758,11.367874248827986,10,0,0,10
65.7631525294699,22.872162988641907,11.74301409903931,31.147975441788684,7,0,0,7
77.97951280646896,32.80857214344828,25.00997260016271,20.160968062857965,9,4,0,13
41.200332001123414,24.831700374526505,16.3686316265969,0.0,8,0,0,8
83.97594221423219,31.25274181062323,25.07479886403042,27.648401539578526,20,14,30,64
59.20582679038,27.440957495201854,21.684385263749164,10.080484031428982,6,0,0,6
10.140571682170698,10.140571682170698,0.0,0.0,13,0,0,13
75.17901820738388,22.812362255047322,21.898311934512606,30.468344017823934,12,14,30,56
71.76917942426735,28.639464524213974,19.977144346607048,23.152570553446335,16,10,10,36
72.46640904486213,29.245751150818137,19.234443229016954,23.98621466502705,5,0,0,5
83.74580897750182,30.00159491797642,21.914518500479534,31.829695559045856,19,13,0,32
63.78904364582714,25.839748777669403,16.55662779181326,21.392667076344466,14,0,0,14
64.940876292138,26.456832668439,22.56901967533983,15.915023948359181,17,12,20,49
31.71941160547361,11.79050016427891,6.025019738035607,13.903891703159093,10,0,0,10
20.31388282019112,12.311444133449163,1.8467166200173746,6.155722066724581,8,0,0,8
100.1176819172921,35.59610148975983,27.149239307797153,37.372341119735104,18,16,15,49
32.00975474696782,15.389305166811454,10.46472751343179,6.155722066724581,17,11,0,28
32.64170308844984,17.8108852717468,10.196187248983335,4.634630567719698,14,11,0,25
35.08761578033012,20.92945502686358,14.158160753466538,0.0,16,0,5,21
47.02131718456883,23.175306301943987,12.061314578006494,11.784696304618347,13,2,5,20
45.83147967985816,24.615237040128864,9.848368390901314,11.367874248827986,10,0,0,10
69.25308992386009,30.7349426774146,22.603123298086313,15.915023948359181,20,15,5,40
42.63331772452122,22.724380623407146,11.91353221277173,7.995404888342351,15,13,0,28
37.297995410404624,20.625113178790244,5.305007982786393,11.367874248827986,11,0,0,11
57.07430731194904,24.111261281764158,14.016588948804909,18.94645708137998,11,1,15,27
59.363039327379745,25.441302568877035,13.724813509751655,20.196923248751055,18,12,20,50
52.73177934889675,22.720591331990867,14.437200296011543,15.573987720894342,22,16,15,53
19.69831061351866,10.46472751343179,3.0778610333622907,6.155722066724581,15,0,0,15
19.082738406846204,11.080299720104247,1.8467166200173746,6.155722066724581,14,0,0,14
55.13419010681573,28.65841098129535,18.48037423717803,7.995404888342351,13,0,0,13
52.8690594973113,25.933746860277584,20.452686250262662,6.48262638677105,12,5,20,37
43.10206427979319,20.39237449796667,13.440428646387124,9.269261135439397,5,0,0,5
28.931893713605536,19.082738406846204,9.84915530675933,0.0,4,0,0,4
33.56862920199377,21.004145732905673,7.929852901368403,4.634630567719698,15,0,0,15
11.695871926776706,11.695871926776706,0.0,0.0,7,0,0,7
48.66208036781633,23.406453078336824,21.466335873203516,3.7892914162759954,9,6,0,15
21.545027233536036,11.695871926776706,9.84915530675933,0.0,21,15,0,36
67.9268379281635,26.263578806208926,18.510688568508236,23.152570553446335,9,7,10,26
57.77153693254383,27.040383546545502,15.573987720894342,15.157165665103982,17,10,10,37
84.67282455081006,27.57385133613066,20.731439184893816,36.36753402978559,16,9,5,30
19.836218829840305,19.836218829840305,0.0,0.0,7,1,15,23
60.25019738035607,24.841619842977583,15.94312915295576,19.465448384422732,9,4,0,13
61.45520132796319,24.285464174851217,16.777362655145307,20.39237449796667,20,16,15,51
32.62532695364028,13.542588546794079,12.927016340121622,6.155722066724581,18,13,0,31
35.08761578033012,20.313882820191118,2.4622888266898326,12.311444133449163,10,0,0,10
30.49586913559561,16.128514375664547,0.4634630567719698,13.903891703159093,13,0,0,13
28.64201690850773,21.226608000156215,7.415408908351517,0.0,6,0,0,6
60.52827521441925,18.816600104941976,13.903891703159093,27.807783406318187,11,0,0,11
56.26441509211713,24.285464174851217,13.440428646387124,18.538522270878794,16,14,20,50
37.54990460701995,17.851593993501286,13.542588546794079,6.155722066724581,7,0,0,7
49.24577653379666,22.160599440208493,14.773732960138997,12.311444133449163,14,3,20,37
38.0,22.0,16.0,0.0,13,0,0,13
89.35149159578798,30.920617956812123,22.811534325981494,35.619339312994356,19,14,20,53
49.24577653379666,22.77617164688095,14.158160753466538,12.311444133449163,12,0,0,12
51.07362885627107,25.583160733812736,6.951945851579547,18.538522270878794,15,13,0,28
31.0,12.0,9.0,10.0,4,0,0,4
45.429228852427414,23.884201618891375,9.233583100086872,12.311444133449163,16,0,0,16
36.31876019367503,16.00487737348391,8.002438686741955,12.311444133449163,15,0,0,15
41.0,17.0,14.0,10.0,12,0,0,12
37.42679016568545,15.88176293214942,9.233583100086872,12.311444133449163,10,0,0,10
48.014632120451736,19.69831061351866,16.00487737348391,12.311444133449163,8,0,0,8
44.0,20.0,14.0,10.0,8,0,0,8
46.53169089990577,21.504685834219398,11.123113362527276,13.903891703159093,18,0,0,18
30.9017247749574,11.203414161438738,1.2311444133449163,18.467166200173743,15,0,0,15
33.0,20.0,13.0,0.0,9,0,0,9
52.9392097738314,24.622888266898325,16.00487737348391,12.311444133449163,12,2,0,14
48.570928349702434,20.299681886612277,14.367354759931064,13.903891703159093,17,15,0,32
12.606195144197578,9.36195374679379,3.2442413974037887,0.0,10,0,0,10
41.0,19.0,12.0,10.0,5,0,0,5
24.992231590901802,17.605365110832302,7.386866480069498,0.0,11,0,0,11
63.309053555051065,26.973549904128642,17.79698138004364,18.538522270878794,22,16,15,53
37.0,15.0,12.0,10.0,17,0,0,17
27.0,12.0,5.0,10.0,21,15,0,36
32.0,20.0,12.0,0.0,14,0,0,14
17.0,14.0,3.0,0.0,11,0,0,11
14.28127519480103,13.66570298812857,0.6155722066724582,0.0,14,0,0,14
19.836218829840305,19.836218829840305,0.0,0.0,15,13,0,28
27.0,18.0,9.0,0.0,10,0,0,10
32.62532695364028,13.542588546794079,12.927016340121622,6.155722066724581,12,0,0,12
30.49586913559561,16.128514375664547,0.4634630567719698,13.903891703159093,9,0,0,9
38.3747411007191,20.763144943384248,8.342335021895456,9.269261135439397,17,1,10,28
27.344320349546216,17.148133100562884,10.196187248983335,0.0,7,0,0,7
13.0,13.0,0.0,0.0,4,0,0,4
20.92945502686358,14.158160753466538,6.771294273397039,0.0,21,15,20,56
16.00487737348391,15.389305166811454,0.6155722066724582,0.0,14,13,0,27
36.31876019367503,21.545027233536036,14.773732960138997,0.0,10,3,0,13
17.0,17.0,0.0,0.0,13,0,0,13
19.69831061351866,16.00487737348391,3.693433240034749,0.0,13,0,0,13
89.35149159578798,30.920617956812123,22.811534325981494,35.619339312994356,15,14,0,29
49.24577653379666,22.77617164688095,14.158160753466538,12.311444133449163,12,0,0,12
28.316321506933075,19.082738406846204,9.233583100086872,0.0,12,0,0,12
12.0,12.0,0.0,0.0,16,15,20,51
22.0,13.0,9.0,0.0,8,0,0,8
48.014632120451736,19.69831061351866,16.00487737348391,12.311444133449163,22,16,10,48
48.84900618376561,27.6223981836094,16.59197743243652,4.634630567719698,7,0,0,7
46.53169089990577,21.504685834219398,11.123113362527276,13.903891703159093,19,14,0,33
17.0,17.0,0.0,0.0,6,0,0,6
11.695871926776706,11.695871926776706,0.0,0.0,11,4,0,15
52.9392097738314,24.622888266898325,16.00487737348391,12.311444133449163,18,16,10,44
12.606195144197578,9.36195374679379,3.2442413974037887,0.0,18,13,0,31
24.992231590901802,17.605365110832302,7.386866480069498,0.0,16,2,20,38
35.70318798700257,22.160599440208493,13.542588546794079,0.0,9,0,0,9
19.836218829840305,19.836218829840305,0.0,0.0,20,15,0,35
61.45520132796319,24.285464174851217,16.777362655145307,20.39237449796667,13,15,0,28
32.62532695364028,13.542588546794079,12.927016340121622,6.155722066724581,14,1,15,30
16.22120698701894,16.22120698701894,0.0,0.0,10,0,0,10
38.3747411007191,20.763144943384248,8.342335021895456,9.269261135439397,16,0,0,16
28.64201690850773,21.226608000156215,7.415408908351517,0.0,16,16,15,47
56.26441509211713,24.285464174851217,13.440428646387124,18.538522270878794,8,3,20,31
20.92945502686358,14.158160753466538,6.771294273397039,0.0,11,14,20,45
49.24577653379666,22.160599440208493,14.773732960138997,12.311444133449163,5,0,0,5
16.00487737348391,15.389305166811454,0.6155722066724582,0.0,6,2,0,8
19.69831061351866,16.00487737348391,3.693433240034749,0.0,14,0,0,14
89.35149159578798,30.920617956812123,22.811534325981494,35.619339312994356,22,16,15,53
16.0,16.0,0.0,0.0,12,0,0,12
12.0,12.0,0.0,0.0,19,14,20,53
26.0,17.0,9.0,0.0,9,0,0,9
26.4696048869157,19.69831061351866,6.771294273397039,0.0,7,0,0,7
20.0,16.0,4.0,0.0,9,0,0,9
12.606195144197578,9.36195374679379,3.2442413974037887,0.0,18,13,0,31
65.16290578213895,23.45123067266167,12.976965589615155,28.73470951986213,15,4,0,19
8.0,8.0,0.0,0.0,12,0,0,12
35.90353616921506,18.60542085391514,5.513419010681574,11.784696304618347,17,13,0,30
39.079204947012485,22.39453490322158,12.050039476071214,4.634630567719698,11,0,0,11
19.836218829840305,19.836218829840305,0.0,0.0,10,0,0,10
60.25019738035607,24.841619842977583,15.94312915295576,19.465448384422732,14,0,5,19
32.62532695364028,13.542588546794079,12.927016340121622,6.155722066724581,15,13,5,33
16.22120698701894,16.22120698701894,0.0,0.0,21,15,0,36
30.49586913559561,16.128514375664547,0.4634630567719698,13.903891703159093,11,0,0,11
38.3747411007191,20.763144943384248,8.342335021895456,9.269261135439397,18,2,0,20
28.64201690850773,21.226608000156215,7.415408908351517,0.0,20,14,20,54
27.344320349546216,17.148133100562884,10.196187248983335,0.0,16,0,0,16
13.54258854679408,13.542588546794079,0.0,0.0,14,0,0,14
13.0,13.0,0.0,0.0,13,0,0,13
29.754328244760462,17.70428876868925,2.780778340631819,9.269261135439397,12,0,0,12
28.316321506933075,17.23602178682883,4.924577653379665,6.155722066724581,7,0,0,7
20.92945502686358,14.158160753466538,6.771294273397039,0.0,22,16,10,48
11.695871926776706,11.695871926776706,0.0,0.0,5,0,0,5
38.0,22.0,16.0,0.0,16,0,0,16
17.23602178682883,17.23602178682883,0.0,0.0,11,0,0,11
16.00487737348391,15.389305166811454,0.6155722066724582,0.0,17,0,0,17
13.54258854679408,13.542588546794079,0.0,0.0,11,0,0,11
17.0,17.0,0.0,0.0,15,0,0,15
89.35149159578798,30.920617956812123,22.811534325981494,35.619339312994356,19,13,5,37
49.24577653379666,22.77617164688095,14.158160753466538,12.311444133449163,13,0,0,13
12.0,12.0,0.0,0.0,12,16,10,38
12.0,12.0,0.0,0.0,7,0,0,7
17.0,17.0,0.0,0.0,10,0,0,10
48.014632120451736,19.69831061351866,16.00487737348391,12.311444133449163,12,0,0,12
7.0,7.0,0.0,0.0,8,0,0,8
46.53169089990577,21.504685834219398,11.123113362527276,13.903891703159093,9,0,0,9
17.0,17.0,0.0,0.0,17,4,0,21
20.0,16.0,4.0,0.0,8,0,0,8
11.0,11.0,0.0,0.0,6,0,0,6
52.9392097738314,24.622888266898325,16.00487737348391,12.311444133449163,15,3,20,38
12.606195144197578,9.36195374679379,3.2442413974037887,0.0,10,15,0,25
6.0,6.0,0.0,0.0,18,0,0,18
24.992231590901802,17.605365110832302,7.386866480069498,0.0,9,1,10,20
63.309053555051065,26.973549904128642,17.79698138004364,18.538522270878794,14,14,20,48
13.0,13.0,0.0,0.0,4,0,0,4
24.62288826689833,17.23602178682883,7.386866480069498,0.0,8,3,5,16
17.426210934626063,17.426210934626067,0.0,0.0,9,2,20,31
31.39418254029537,20.92945502686358,10.46472751343179,0.0,10,13,0,23
58.43087363897585,29.556473046952764,16.748668059939902,12.125732532083186,11,14,5,30
40.32128593916137,19.00198532765076,12.050039476071214,9.269261135439397,12,16,15,43
18.816600104941973,15.108895650766216,3.7077044541757584,0.0,6,1,15,22
27.700749300260618,17.23602178682883,10.46472751343179,0.0,16,14,5,35
38.83820415749106,19.836218829840305,5.098093624491668,13.903891703159093,22,16,15,53
14.0,14.0,0.0,0.0,17,15,20,52
12.0,12.0,0.0,0.0,15,13,0,28
38.16547681369241,22.160599440208493,16.00487737348391,0.0,19,15,20,54
15.0,15.0,0.0,0.0,14,4,0,18
12.0,12.0,0.0,0.0,7,0,0,7
19.082738406846204,13.542588546794079,5.540149860052123,0.0,6,5,0,11
31.39418254029537,16.62044958015637,8.618010893414414,6.155722066724581,10,4,0,14
61.2698161052544,24.656234620268794,13.440428646387124,23.17315283859849,4,10,20,34
34.57434403518894,20.206989275257886,5.098093624491668,9.269261135439397,15,10,20,45
83.06126784476982,24.25146506416637,23.94832175086429,34.86148102973916,19,14,0,33
13.0,13.0,0.0,0.0,11,1,15,27
29.0,14.0,5.0,10.0,17,13,0,30
38.16547681369241,16.62044958015637,9.233583100086872,12.311444133449163,13,15,0,28
20.485067109321065,16.31389959837334,4.171167510947728,0.0,8,9,0,17
19.69831061351866,14.158160753466538,5.540149860052123,0.0,22,16,15,53
30.125098690178035,21.31930061151061,8.805798078667426,0.0,14,9,0,23
25.39777551110394,20.763144943384248,4.634630567719698,0.0,15,11,0,26
33.0,19.0,14.0,0.0,13,8,0,21
45.326686952298644,24.470849397560006,11.586576419299245,9.269261135439397,18,14,0,32
8.0,8.0,0.0,0.0,14,12,0,26
12.311444133449164,12.311444133449163,0.0,0.0,8,3,0,11
11.080299720104247,11.080299720104247,0.0,0.0,17,12,0,29
8.0,8.0,0.0,0.0,9,2,0,11
73.20911016245222,25.615609974025727,16.52131057496334,31.072189613463163,21,15,0,36
46.34630567719698,23.63661589537046,13.440428646387124,9.269261135439397,12,16,15,43
16.00487737348391,16.00487737348391,0.0,0.0,16,13,0,29
23.0,14.0,9.0,0.0,12,11,0,23
12.68078745745264,12.680787457452638,0.0,0.0,11,6,0,17
57.59722952739513,28.597782318634938,17.214750904141848,11.784696304618347,16,0,10,26
36.869805480365436,19.817994107123454,9.47322854068999,7.578582832551991,12,0,20,32
41.605078606419724,16.578073540733357,6.488482794807577,18.538522270878794,13,0,20,33
15.232951493429503,11.064730935525906,4.168220557903595,0.0,10,0,10,20
61.6441927599779,27.669405921647318,16.809296722600315,17.165490115730258,14,0,10,24
19.69831061351866,14.158160753466538,5.540149860052123,0.0,6,0,0,6
50.53399032745668,21.14803539423633,10.439497851840368,18.94645708137998,11,0,20,31
27.700749300260618,14.158160753466538,13.542588546794079,0.0,7,0,5,12
53.18238576458353,18.635849512800906,10.863574050734972,23.68296220104766,15,0,5,20
69.76926648762343,30.354898056055443,19.609944819982427,19.80442361158556,18,0,0,18
40.14980460815574,18.580233945988272,7.66567895900838,13.903891703159093,19,0,5,24
22.776171646880954,16.00487737348391,6.771294273397039,0.0,9,0,0,9
43.347699699882334,18.788792321535656,10.655015675187586,13.903891703159093,22,0,0,22
11.0,11.0,0.0,0.0,13,9,0,22
57.59722952739513,28.597782318634938,17.214750904141848,11.784696304618347,17,11,0,28
58.006540908827354,28.23183791438792,16.096361318352514,13.678341676086916,15,12,5,32
34.903402805497045,20.591663612378618,14.311739193118427,0.0,18,13,10,41
75.83129982251522,30.113498885145336,22.98205243971391,22.735748497655972,11,13,10,34
48.142947443786525,25.91875328732781,18.434902740182718,3.7892914162759954,10,6,0,16
47.79433263348913,23.008577479627846,8.378123321386227,16.407631832475058,13,8,0,21
46.479448512041365,20.556905933297276,13.72102421833538,12.201518360408707,15,10,0,25
36.76188966315264,19.460813753855014,12.666445341577933,4.634630567719698,11,2,15,28
59.93522233123741,28.059702937523745,20.507645144885686,11.367874248827986,21,16,20,57
56.95311412097707,28.906031058612115,17.966599030935964,10.080484031428982,16,14,30,60
61.6441927599779,27.669405921647318,16.809296722600315,17.165490115730258,22,16,20,58
28.316321506933075,14.773732960138997,1.2311444133449163,12.311444133449163,10,0,0,10
19.69831061351866,14.158160753466538,5.540149860052123,0.0,17,12,5,34
7.386866480069498,7.386866480069498,0.0,0.0,14,11,0,25
30.996409236909336,17.092517533750243,9.269261135439397,4.634630567719698,5,0,0,5
40.159073869291184,19.66473749883468,11.225075235017108,9.269261135439397,12,0,0,12
45.509389909474706,19.91651568394663,14.224999976700087,11.367874248827986,8,4,10,22
50.53399032745668,21.14803539423633,10.439497851840368,18.94645708137998,16,15,15,46
58.40434859906191,22.07641179122395,13.175366254391635,23.152570553446335,14,10,0,24
27.700749300260618,14.158160753466538,13.542588546794079,0.0,8,5,5,18
53.18238576458353,18.635849512800906,10.863574050734972,23.68296220104766,12,9,0,21
6.77129427339704,6.771294273397039,0.0,0.0,7,0,0,7
69.76926648762343,30.354898056055443,19.609944819982427,19.80442361158556,19,14,30,63
22.776171646880954,16.00487737348391,6.771294273397039,0.0,4,0,0,4
29.70798193908326,16.73101634946811,8.342335021895456,4.634630567719698,9,0,0,9
41.030384416022486,19.715718435079594,16.680035413223194,4.634630567719698,12,7,0,19
77.13860536113043,28.900925631937017,23.228356381771853,25.00932334742157,17,15,30,62
57.115989517528085,21.341289256466407,5.725619329993029,30.049080931068644,16,0,0,16
87.22323318622153,34.63481015538971,24.88628080605143,27.702142224780395,22,16,20,58
27.08517709358816,15.389305166811454,5.540149860052123,6.155722066724581,4,0,0,4
49.03343092661138,24.70996932553577,16.744878768523623,7.578582832551991,15,10,0,25
36.93433240034749,19.082738406846204,11.695871926776706,6.155722066724581,7,0,0,7
81.50765836409664,29.692887537938702,24.456086800645274,27.358684025512687,20,14,15,49
19.082738406846204,13.542588546794079,5.540149860052123,0.0,13,14,15,42
21.545027233536036,16.00487737348391,5.540149860052123,0.0,11,6,0,17
15.389305166811454,14.773732960138997,0.6155722066724582,0.0,12,9,0,21
28.931893713605536,17.23602178682883,11.695871926776706,0.0,13,4,10,27
64.87266904664504,25.539824145700212,20.386387819564856,18.94645708137998,10,3,15,28
41.2435774221376,20.387739867398952,11.586576419299245,9.269261135439397,11,0,0,11
35.11659581161215,20.285777994909118,10.196187248983335,4.634630567719698,15,9,0,24
22.160599440208493,15.389305166811454,6.771294273397039,0.0,9,0,0,9
42.83415016958385,20.62890247020652,10.837373450549348,11.367874248827986,10,11,0,21
14.773732960138997,10.46472751343179,4.309005446707207,0.0,12,2,30,44
33.8564713669852,18.467166200173743,15.389305166811454,0.0,21,15,30,66
28.692514604041836,22.326505024698168,6.366009579343672,0.0,9,1,20,30
41.80346290435678,27.025226380880397,14.778236523476382,0.0,8,0,0,8
31.68984411431615,22.21661557362616,9.47322854068999,0.0,5,0,0,5
35.00999930855459,21.569570662167475,8.805798078667426,4.634630567719698,7,5,5,17
49.113180126125634,27.335051088410783,17.143498469995166,4.634630567719698,14,10,0,24
12.311444133449164,12.311444133449163,0.0,0.0,18,11,0,29
36.303061236948395,15.447223682209753,6.951945851579547,13.903891703159093,16,13,10,39
49.901178660938584,25.448881151709585,12.250779148820293,12.201518360408707,13,12,0,25
19.476957879658617,16.82445388826542,2.6525039913931967,0.0,18,12,5,35
48.76060194463951,25.229102249565578,12.163625446245947,11.367874248827986,16,12,5,33
9.84915530675933,9.84915530675933,0.0,0.0,6,7,0,13
51.28048073646304,24.800912319526386,11.322402751832675,15.157165665103982,14,0,0,14
28.931893713605536,17.851593993501286,11.080299720104247,0.0,12,8,0,20
9.233583100086873,9.233583100086872,0.0,0.0,19,13,10,42
41.2435774221376,16.680035413223194,10.659650305755305,13.903891703159093,9,16,20,45
43.10697915155572,21.88694722041015,6.062866266041593,15.157165665103982,7,0,0,7
23.39174385355341,16.62044958015637,6.771294273397039,0.0,16,4,0,20
35.47346236532656,23.886885946027324,11.586576419299245,0.0,10,1,30,41
18.467166200173747,16.00487737348391,2.4622888266898326,0.0,14,0,5,19
51.916113418455964,22.423404671841062,10.044829586301743,19.44787916031315,17,9,0,26
26.4696048869157,16.00487737348391,10.46472751343179,0.0,13,0,0,13
61.12505983594808,24.70996932553577,17.46863342903234,18.94645708137998,11,3,10,24
56.684010296072614,28.942607837516054,12.167414737662222,15.573987720894342,13,15,20,48
13.54258854679408,13.542588546794079,0.0,0.0,12,0,0,12
34.24065063431313,19.409832817610095,10.196187248983335,4.634630567719698,9,0,0,9
59.11294609390553,23.497396072327447,12.87980152392211,22.735748497655972,16,12,10,38
19.69831061351866,12.927016340121622,0.6155722066724582,6.155722066724581,8,0,0,8
76.23568630842755,25.946712113051127,22.64057265579789,27.648401539578526,15,14,10,39
44.21437561604592,16.40659220972773,9.269261135439397,18.538522270878794,18,11,0,29
28.08586124038137,14.645432593994247,4.171167510947728,9.269261135439397,11,8,0,19
90.4042721749579,32.75756920957039,28.232790881197406,29.413912084190102,17,13,5,35
29.056286580004336,20.340916322569544,8.71537025743479,0.0,5,0,0,5
58.39634515326819,22.24622672505455,12.976965589615155,23.17315283859849,11,11,0,22
20.31388282019112,11.080299720104247,3.0778610333622907,6.155722066724581,6,0,0,6
30.01850218712048,14.724221313645481,6.025019738035607,9.269261135439397,9,2,20,31
41.34090466405971,18.167751825461217,9.269261135439397,13.903891703159093,14,7,0,21
26.4696048869157,14.158160753466538,6.155722066724581,6.155722066724581,4,0,0,4
19.69831061351866,13.542588546794079,6.155722066724581,0.0,12,9,0,21
21.5951717813569,17.805880365080903,3.7892914162759954,0.0,12,10,0,22
16.684670043790913,16.22120698701894,0.4634630567719698,0.0,10,5,10,25
30.778610333622908,11.080299720104247,7.386866480069498,12.311444133449163,6,6,0,12
18.467166200173747,18.467166200173743,0.0,0.0,19,13,5,37
12.0,12.0,0.0,0.0,8,0,0,8
36.34940754262559,22.908978896238466,13.440428646387124,0.0,10,0,0,10
57.5858616531463,26.013485572734712,16.415210415307612,15.157165665103982,13,16,30,59
10.46472751343179,10.46472751343179,0.0,0.0,14,0,0,14
12.927016340121622,12.311444133449163,0.6155722066724582,0.0,15,0,0,15
48.01477268157607,24.841619842977583,13.903891703159093,9.269261135439397,22,16,30,68
44.05430200562472,19.802836941458352,9.09429939906239,15.157165665103982,21,15,20,56
60.09816186213728,25.357938157718962,15.79376662303835,18.94645708137998,19,12,10,41
4.0,4.0,0.0,0.0,18,10,0,28
43.10697915155572,21.88694722041015,6.062866266041593,15.157165665103982,4,0,0,4
44.111031248783604,24.880320072427285,9.506771596199744,9.723939580156575,14,12,25,51
33.554175491123935,16.50236411788196,9.47322854068999,7.578582832551991,18,13,5,36
35.47346236532656,23.886885946027324,11.586576419299245,0.0,15,9,10,34
42.39838165671211,21.56864674144297,10.977577232951559,9.85215768231759,19,14,5,38
45.5469329934534,24.6988065335977,15.662025350438856,5.18610110941684,15,11,30,56
25.1753132438534,18.223367392273854,6.951945851579547,0.0,11,8,10,29
30.778610333622908,16.00487737348391,8.618010893414414,6.155722066724581,7,0,0,7
50.230692064472585,21.052569468198072,10.710956396100771,18.467166200173743,12,2,5,19
51.916113418455964,22.423404671841062,10.044829586301743,19.44787916031315,11,10,10,31
55.736687442003614,22.830480783062875,15.816502371536004,17.08970428740474,9,5,25,39
36.150118428213645,17.148133100562884,5.098093624491668,13.903891703159093,18,12,25,55
61.12505983594808,24.70996932553577,17.46863342903234,18.94645708137998,14,4,5,23
70.86732806719365,31.890676559378775,25.676238636686143,13.300412871128746,17,11,30,58
12.311444133449164,12.311444133449163,0.0,0.0,22,16,0,38
76.23568630842755,25.946712113051127,22.64057265579789,27.648401539578526,20,14,5,39
56.03604146388942,24.1681006530083,7.9575119741795906,23.91042883670153,16,13,5,34
90.4042721749579,32.75756920957039,28.232790881197406,29.413912084190102,12,15,5,32
30.17144499585523,19.048331633327958,11.123113362527276,0.0,8,1,0,9
58.39634515326819,22.24622672505455,12.976965589615155,23.17315283859849,8,6,30,44
20.31388282019112,11.080299720104247,3.0778610333622907,6.155722066724581,10,0,0,10
41.34090466405971,18.167751825461217,9.269261135439397,13.903891703159093,14,0,10,24
9.233583100086873,8.618010893414414,0.6155722066724582,0.0,9,0,0,9
19.69831061351866,13.542588546794079,6.155722066724581,0.0,13,0,0,13
31.39418254029537,17.23602178682883,8.002438686741955,6.155722066724581,7,0,0,7
21.5951717813569,17.805880365080903,3.7892914162759954,0.0,10,7,10,27
16.684670043790913,16.22120698701894,0.4634630567719698,0.0,11,0,0,11
23.39174385355341,15.389305166811454,8.002438686741955,0.0,6,0,0,6
13.069658200969547,13.069658200969549,0.0,0.0,12,0,0,12
33.619610138238684,18.325329264763685,1.3903891703159095,13.903891703159093,5,3,5,13
31.770392541718525,19.256890008875345,12.513502532843185,0.0,21,15,5,41
57.5858616531463,26.013485572734712,16.415210415307612,15.157165665103982,13,9,10,32
60.09816186213728,25.357938157718962,15.79376662303835,18.94645708137998,16,16,0,32
4.0,4.0,0.0,0.0,17,10,0,27
15.0,15.0,0.0,0.0,14,14,0,28
19.69831061351866,16.00487737348391,3.693433240034749,0.0,11,1,15,27
16.0,16.0,0.0,0.0,7,14,0,21
26.0,17.0,9.0,0.0,12,16,15,43
51.07362885627107,25.583160733812736,6.951945851579547,18.538522270878794,18,14,0,32
31.0,12.0,9.0,10.0,11,0,0,11
12.0,12.0,0.0,0.0,14,13,5,32
11.0,11.0,0.0,0.0,8,0,0,8
17.23602178682883,17.23602178682883,0.0,0.0,22,16,15,53
18.0,13.0,5.0,0.0,10,4,5,19
27.0,18.0,9.0,0.0,9,0,0,9
20.0,16.0,4.0,0.0,16,15,20,51
48.570928349702434,20.299681886612277,14.367354759931064,13.903891703159093,20,15,20,55
14.0,14.0,0.0,0.0,13,2,20,35
14.0,14.0,0.0,0.0,5,0,0,5
13.0,13.0,0.0,0.0,15,3,0,18
54.03979241961167,22.060841502345763,13.440428646387124,18.538522270878794,17,13,5,35
100.1176819172921,35.59610148975983,27.149239307797153,37.372341119735104,10,1,20,31
59.84436548947695,23.70048207003496,18.93251036256485,17.21137305687714,19,16,20,55
35.39956041085035,23.360981581341512,12.038578829508838,0.0,6,4,0,10
69.25308992386009,30.7349426774146,22.603123298086313,15.915023948359181,22,16,20,58
18.467166200173747,13.542588546794079,4.924577653379665,0.0,15,14,10,39
21.545027233536036,15.389305166811454,6.155722066724581,0.0,14,13,0,27
43.54653695584374,24.221150732836165,7.9575119741795906,11.367874248827986,17,15,0,32
59.363039327379745,25.441302568877035,13.724813509751655,20.196923248751055,16,15,0,31
41.40179801423153,21.701271941012628,12.12194324066691,7.578582832551991,8,3,10,21
32.33581747098033,18.431925767821237,9.269261135439397,4.634630567719698,11,13,0,24
20.31388282019112,14.773732960138997,5.540149860052123,0.0,9,2,0,11
48.66208036781633,23.406453078336824,21.466335873203516,3.7892914162759954,12,14,10,36
33.24089916031274,20.313882820191118,12.927016340121622,0.0,16,2,0,18
74.87757608039902,26.776488290557822,23.110563068838793,24.990524721002394,18,11,25,54
67.78558281327149,28.95789206970628,19.379811583252053,19.44787916031315,11,6,25,42
32.64170308844984,21.518589725922556,11.123113362527276,0.0,16,9,0,25
45.55234329376191,22.160599440208493,17.23602178682883,6.155722066724581,10,0,0,10
63.40393728726319,26.4696048869157,18.467166200173743,18.467166200173743,19,13,15,47
44.3997608387547,17.055440489208486,8.805798078667426,18.538522270878794,7,0,0,7
14.0,14.0,0.0,0.0,8,8,0,16
39.39662122703732,20.92945502686358,12.311444133449163,6.155722066724581,13,4,5,22
10.0,10.0,0.0,0.0,6,0,0,6
50.230692064472585,21.052569468198072,10.710956396100771,18.467166200173743,15,12,5,32
48.29285051563925,25.119697677040765,13.903891703159093,9.269261135439397,12,10,0,22
56.684010296072614,28.942607837516054,12.167414737662222,15.573987720894342,11,11,25,47
22.776171646880954,14.773732960138997,1.8467166200173746,6.155722066724581,10,0,0,10
17.23602178682883,17.23602178682883,0.0,0.0,15,0,0,15
59.41596387816652,20.948530166093036,19.928911441194703,18.538522270878794,15,7,0,22
38.16547681369241,16.62044958015637,9.233583100086872,12.311444133449163,20,14,5,39
32.00975474696782,18.467166200173743,13.542588546794079,0.0,17,10,0,27
78.97410487394365,29.012787353925308,22.153534113700154,27.807783406318187,12,13,15,40
23.91469372943364,16.499284821082124,2.780778340631819,4.634630567719698,13,0,0,13
11.695871926776706,11.695871926776706,0.0,0.0,9,0,0,9
10.0,10.0,0.0,0.0,9,0,0,9
68.03637673412517,25.02700506568637,19.836218829840305,23.17315283859849,22,16,30,68
16.00487737348391,14.158160753466538,1.8467166200173746,0.0,16,0,0,16
35.21073022166461,15.512419608145946,1.2311444133449163,18.467166200173743,14,0,10,24
31.0,15.0,6.0,10.0,10,0,0,10
34.0,20.0,14.0,0.0,5,0,0,5
6.0,6.0,0.0,0.0,14,0,0,14
82.25480490854447,27.654884165965296,21.83024435745151,32.76967638512765,13,14,5,32
30.16303812695045,18.467166200173743,11.695871926776706,0.0,17,9,0,26
37.54990460701995,19.082738406846204,12.311444133449163,6.155722066724581,7,0,0,7
38.16547681369241,17.23602178682883,14.773732960138997,6.155722066724581,21,15,15,51
68.40467363320812,28.202666095647448,23.99544157063304,16.206565966927624,18,16,30,64
36.0,21.0,15.0,0.0,11,3,5,19
33.8564713669852,20.313882820191118,13.542588546794079,0.0,6,0,15,21
100.63221214204161,31.265443475693235,24.918380353430944,44.44838831291742,12,15,15,42
29.547465920277993,18.467166200173743,11.080299720104247,0.0,4,0,0,4
37.91127804394713,20.299681886612277,3.7077044541757584,13.903891703159093,9,5,5,19
28.43943594826757,15.512419608145946,6.771294273397039,6.155722066724581,19,12,5,36
24.0,15.0,9.0,0.0,17,12,15,44
20.0,15.0,5.0,0.0,18,14,0,32
31.39418254029537,19.082738406846204,12.311444133449163,0.0,8,4,0,12
44.42186327300349,26.991122758133912,9.85215768231759,7.578582832551991,11,10,10,31
35.501270148732885,23.91469372943364,6.951945851579547,4.634630567719698,10,6,30,46
48.29285051563925,25.119697677040765,13.903891703159093,9.269261135439397,16,14,0,30
29.939713467469243,21.133915388801825,8.805798078667426,0.0,12,9,25,46
51.62978452439744,21.041222777447427,12.050039476071214,18.538522270878794,9,8,25,42
59.41596387816652,20.948530166093036,19.928911441194703,18.538522270878794,15,11,30,56
23.91469372943364,16.499284821082124,2.780778340631819,4.634630567719698,6,2,5,13
21.0,14.0,7.0,0.0,22,16,0,38
43.459397791075546,21.91437055753951,9.233583100086872,12.311444133449163,14,12,15,41
37.54990460701995,19.082738406846204,12.311444133449163,6.155722066724581,17,13,0,30
38.16547681369241,17.23602178682883,14.773732960138997,6.155722066724581,15,15,5,35
27.0,13.0,14.0,0.0,11,11,30,52
12.311444133449164,12.311444133449163,0.0,0.0,10,5,15,30
29.547465920277993,18.467166200173743,11.080299720104247,0.0,8,7,10,25
8.0,8.0,0.0,0.0,7,3,0,10
4.0,4.0,0.0,0.0,5,1,0,6
33.24089916031274,16.62044958015637,4.309005446707207,12.311444133449163,20,16,0,36
9.233583100086873,9.233583100086872,0.0,0.0,14,10,10,34
39.80220731557676,17.555980590522214,8.342335021895456,13.903891703159093,13,13,0,26
36.448566859620236,25.752233321447996,10.696333538172233,0.0,13,4,10,27
74.87757608039902,26.776488290557822,23.110563068838793,24.990524721002394,22,16,30,68
19.082738406846204,11.695871926776706,7.386866480069498,0.0,8,3,20,31
67.78558281327149,28.95789206970628,19.379811583252053,19.44787916031315,6,14,20,40
27.700749300260618,16.62044958015637,11.080299720104247,0.0,7,10,5,22
45.566229280718844,24.87669814785191,13.110948300314945,7.578582832551991,15,12,0,27
32.00975474696782,19.082738406846204,12.927016340121622,0.0,12,5,0,17
32.62532695364028,19.69831061351866,12.927016340121622,0.0,10,6,5,21
76.0245536847453,29.025972248674123,21.989258088649603,25.00932334742157,17,16,30,63
35.11196118104443,23.525384761745187,11.586576419299245,0.0,5,0,0,5
44.02435576276941,18.070424583539104,12.050039476071214,13.903891703159093,21,15,10,46
68.05188454490059,22.402290853023686,15.676298589133793,29.973295102743123,16,13,10,39
56.13835233212886,23.243513547436958,8.908624119664864,23.98621466502705,18,12,0,30
72.44746258778075,28.715250352539496,19.480747171074892,24.25146506416637,8,9,0,17
88.46840230026453,28.523556101792618,23.577312168686305,36.36753402978559,19,13,10,42
19.082738406846204,14.158160753466538,4.924577653379665,0.0,9,0,0,9
57.104621643279245,28.30221758816541,16.676671523030656,12.125732532083186,14,9,0,23
32.69268402469474,20.179181491851566,7.878871965123487,4.634630567719698,12,0,0,12
31.923335350453275,14.775202249890397,7.878871965123487,9.269261135439397,14,8,0,22
19.69831061351866,11.695871926776706,1.8467166200173746,6.155722066724581,15,10,5,30
19.082738406846204,13.542588546794079,5.540149860052123,0.0,10,0,0,10
50.84471222359131,29.624680292445735,17.013918459079218,4.206113472066355,13,7,5,25
20.132835186174365,12.71742627782285,0.4634630567719698,6.951945851579547,20,14,20,54
16.00487737348391,13.542588546794079,2.4622888266898326,0.0,4,0,0,4
28.266611832522436,18.997350697083043,9.269261135439397,0.0,17,11,5,33
18.467166200173747,11.695871926776706,6.771294273397039,0.0,11,0,0,11
15.389305166811454,11.080299720104247,4.309005446707207,0.0,16,15,10,41
12.927016340121622,12.927016340121622,0.0,0.0,9,2,10,21
32.48876027971508,16.73101634946811,11.123113362527276,4.634630567719698,11,1,30,42
51.88297807165093,20.431859316560168,10.988945107200387,20.462173647890374,12,11,5,28
36.448566859620236,25.752233321447996,10.696333538172233,0.0,17,14,0,31
45.566229280718844,24.87669814785191,13.110948300314945,7.578582832551991,15,12,0,27
27.08517709358816,16.62044958015637,10.46472751343179,0.0,20,15,0,35
10.46472751343179,10.46472751343179,0.0,0.0,9,1,0,10
72.46640904486213,29.245751150818137,19.234443229016954,23.98621466502705,15,11,0,26
30.778610333622908,18.467166200173743,12.311444133449163,0.0,18,14,0,32
56.13835233212886,23.243513547436958,8.908624119664864,23.98621466502705,6,0,0,6
24.62288826689833,11.695871926776706,6.771294273397039,6.155722066724581,12,13,0,25
29.547465920277993,16.00487737348391,7.386866480069498,6.155722066724581,19,16,0,35
28.113669023787686,14.209777320628595,4.634630567719698,9.269261135439397,10,10,0,20
24.62288826689833,15.389305166811454,9.233583100086872,0.0,16,13,0,29
26.4696048869157,14.158160753466538,12.311444133449163,0.0,10,4,0,14
19.082738406846204,14.158160753466538,4.924577653379665,0.0,11,0,0,11
23.39174385355341,15.389305166811454,8.002438686741955,0.0,14,10,0,24
21.545027233536036,15.389305166811454,6.155722066724581,0.0,17,15,0,32
37.42927646490428,20.744606421113367,12.050039476071214,4.634630567719698,22,16,0,38
28.931893713605536,15.389305166811454,13.542588546794079,0.0,8,7,0,15
42.61816055885612,28.597782318634938,10.231086823945187,3.7892914162759954,13,11,0,24
23.89527167103643,15.937759696856839,0.37892914162759955,7.578582832551991,14,5,0,19
42.71289284426302,21.871790054745045,5.683937124413993,15.157165665103982,5,0,0,5
7.386866480069498,7.386866480069498,0.0,0.0,12,3,0,15
16.37414979575369,13.129908398349905,3.2442413974037887,0.0,11,2,0,13
49.67003188454574,23.52392111224138,10.988945107200387,15.157165665103982,7,12,0,19
17.426210934626063,17.426210934626067,0.0,0.0,16,11,0,27
8.0,8.0,0.0,0.0,14,12,10,36
31.39418254029537,20.92945502686358,10.46472751343179,0.0,13,13,5,31
21.690071056928183,17.055440489208486,4.634630567719698,0.0,12,10,15,37
19.69831061351866,10.834070837435265,1.4773732960138994,7.386866480069498,6,3,30,39
58.43087363897585,29.556473046952764,16.748668059939902,12.125732532083186,12,15,5,32
40.32128593916137,19.00198532765076,12.050039476071214,9.269261135439397,19,14,30,63
18.816600104941973,15.108895650766216,3.7077044541757584,0.0,18,13,5,36
53.5763293628397,25.305082899749554,14.367354759931064,13.903891703159093,17,12,10,39
12.311444133449164,12.311444133449163,0.0,0.0,7,8,0,15
6.0,6.0,0.0,0.0,11,11,0,22
38.83820415749106,19.836218829840305,5.098093624491668,13.903891703159093,15,14,30,59
30.0,19.0,11.0,0.0,20,15,5,40
11.0,11.0,0.0,0.0,10,9,0,19
12.0,12.0,0.0,0.0,9,7,15,31
38.16547681369241,22.160599440208493,16.00487737348391,0.0,17,16,20,53
56.82057076024349,21.875456279636975,20.114296663903488,14.830817816703034,22,16,20,58
7.0,7.0,0.0,0.0,5,1,20,26
10.0,10.0,0.0,0.0,14,9,0,23
9.0,9.0,0.0,0.0,8,4,5,17
12.0,12.0,0.0,0.0,10,5,10,25
15.0,15.0,0.0,0.0,11,6,0,17
7.0,7.0,0.0,0.0,8,2,5,15
14.0,14.0,0.0,0.0,15,10,15,40
62.845590498279115,30.310483912886827,21.411993222865007,11.123113362527276,17,15,15,47
29.055008154940026,15.512419608145946,1.2311444133449163,12.311444133449163,8,2,15,25
21.31930061151061,17.61159615733485,3.7077044541757584,0.0,12,12,0,24
25.238460473570786,19.69831061351866,5.540149860052123,0.0,16,11,0,27
23.39174385355341,16.62044958015637,0.6155722066724582,6.155722066724581,10,6,0,16
13.0,13.0,0.0,0.0,15,14,20,49
7.0,7.0,0.0,0.0,8,10,5,23
56.079029869408345,29.476250410697276,17.33351832327167,9.269261135439397,15,16,30,61
99.45917198326472,31.23741002643077,23.729308506724855,44.4924534501091,22,16,30,68
33.24089916031274,19.69831061351866,13.542588546794079,0.0,11,10,5,26
28.316321506933075,13.542588546794079,8.618010893414414,6.155722066724581,18,13,15,46
19.69831061351866,14.158160753466538,5.540149860052123,0.0,13,3,20,36
77.58371570362775,29.661635633406068,19.18737055035955,28.73470951986213,9,5,0,14
29.012787353925308,18.353137048170005,1.3903891703159095,9.269261135439397,6,8,5,19
12.0,12.0,0.0,0.0,13,7,5,25
51.3827916047025,22.508391012679414,13.717234926919105,15.157165665103982,12,15,15,42
39.48705243697183,21.78276366828258,17.70428876868925,0.0,21,14,20,55
23.265845449952884,13.069658200969549,5.561556681263638,4.634630567719698,19,9,5,33
13.255043423678336,13.255043423678337,0.0,0.0,14,12,0,26
22.616997170472125,19.836218829840305,2.780778340631819,0.0,17,11,0,28
6.0,6.0,0.0,0.0,7,1,30,38
95.33857203350405,34.255194403135,24.70618003411949,36.37719759624956,16,9,30,55
62.845590498279115,30.310483912886827,21.411993222865007,11.123113362527276,14,13,0,27
76.31632912379854,32.05740538169492,21.523175244447653,22.735748497655972,6,5,10,21
17.426210934626063,17.426210934626067,0.0,0.0,9,0,5,14
39.0,16.0,13.0,10.0,12,0,0,12
5.0,5.0,0.0,0.0,4,0,0,4
32.34972136268349,21.226608000156215,6.488482794807577,4.634630567719698,10,4,0,14
87.40913250719349,29.568943022051673,22.616997170472125,35.2231923146697,14,11,0,25
20.485067109321065,15.386973484829399,5.098093624491668,0.0,11,0,5,16
25.0,14.0,11.0,0.0,13,0,0,13
19.558140995777126,15.850436541601368,3.7077044541757584,0.0,5,0,0,5
56.079029869408345,29.476250410697276,17.33351832327167,9.269261135439397,13,15,20,48
42.63860122302122,24.470849397560006,13.533121257741518,4.634630567719698,9,0,0,9
33.46203269893622,21.875456279636975,11.586576419299245,0.0,11,14,10,35
13.0,11.0,2.0,0.0,8,0,0,8
36.225625939598515,20.159030334588298,10.003729338968627,6.062866266041593,16,9,15,40
63.58430996511121,24.17567923584085,20.462173647890374,18.94645708137998,15,12,5,32
44.58514606146349,21.875456279636975,13.440428646387124,9.269261135439397,22,16,0,38
28.316321506933075,13.542588546794079,8.618010893414414,6.155722066724581,14,2,15,31
19.69831061351866,14.158160753466538,5.540149860052123,0.0,20,15,20,55
24.25354494289485,16.251106256152895,8.002438686741955,0.0,10,0,15,25
38.16547681369241,22.160599440208493,16.00487737348391,0.0,15,7,5,27
28.931893713605536,15.389305166811454,7.386866480069498,6.155722066724581,16,1,0,17
56.82057076024349,21.875456279636975,20.114296663903488,14.830817816703034,12,8,30,50
25.238460473570786,17.23602178682883,8.002438686741955,0.0,17,10,0,27
26.0,17.0,9.0,0.0,7,0,0,7
5.0,5.0,0.0,0.0,8,0,0,8
34.852421869252126,20.021604052549097,10.196187248983335,4.634630567719698,13,3,10,26
35.08761578033012,20.92945502686358,14.158160753466538,0.0,19,14,10,43
39.48705243697183,21.78276366828258,17.70428876868925,0.0,21,16,0,37
36.37719759624956,20.462173647890374,8.33644111580719,7.578582832551991,19,13,0,32
32.44241397403788,21.31930061151061,11.123113362527276,0.0,12,6,5,23
31.14471741507637,14.92351042805743,1.3903891703159095,14.830817816703034,17,11,5,33
27.700749300260618,17.23602178682883,4.309005446707207,6.155722066724581,6,0,5,11
63.81166745008777,24.17567923584085,20.689531132866936,18.94645708137998,9,10,5,24
26.973549904128642,13.996584314513488,3.7077044541757584,9.269261135439397,18,12,10,40
20.0,12.0,8.0,0.0,11,0,5,16
95.33857203350405,34.255194403135,24.70618003411949,36.37719759624956,19,13,5,37
76.31632912379854,32.05740538169492,21.523175244447653,22.735748497655972,13,16,30,59
81.16662213663182,28.798614763697564,25.085109175747093,27.28289819718717,22,16,30,68
51.76172074633009,24.47882254914293,17.809669656497178,9.47322854068999,7,13,5,25
53.35322314116602,18.719099596403417,14.171949896872222,20.462173647890374,5,6,5,16
32.34972136268349,21.226608000156215,6.488482794807577,4.634630567719698,12,0,0,12
20.485067109321065,15.386973484829399,5.098093624491668,0.0,10,10,0,20
42.63860122302122,24.470849397560006,13.533121257741518,4.634630567719698,15,0,0,15
33.46203269893622,21.875456279636975,11.586576419299245,0.0,14,9,0,23
33.24089916031274,19.69831061351866,13.542588546794079,0.0,9,0,0,9
72.83018102082463,30.086973845231405,23.79675009421325,18.94645708137998,20,14,20,54
36.225625939598515,20.159030334588298,10.003729338968627,6.062866266041593,16,9,0,25
63.58430996511121,24.17567923584085,20.462173647890374,18.94645708137998,10,15,15,40
38.83820415749106,19.836218829840305,5.098093624491668,13.903891703159093,12,11,5,28
77.58371570362775,29.661635633406068,19.18737055035955,28.73470951986213,9,0,0,9
22.0,10.0,2.0,10.0,4,0,0,4
15.0,9.0,6.0,0.0,17,10,0,27
25.238460473570786,17.23602178682883,8.002438686741955,0.0,11,7,0,18
34.852421869252126,20.021604052549097,10.196187248983335,4.634630567719698,13,3,20,36
35.08761578033012,20.92945502686358,14.158160753466538,0.0,12,5,10,27
36.37719759624956,20.462173647890374,8.33644111580719,7.578582832551991,6,2,15,23
32.44241397403788,21.31930061151061,11.123113362527276,0.0,16,4,5,25
33.27664747622743,18.909292716296367,0.4634630567719698,13.903891703159093,15,1,30,46
7.0,7.0,0.0,0.0,10,0,0,10
63.81166745008777,24.17567923584085,20.689531132866936,18.94645708137998,8,14,20,42
20.0,12.0,8.0,0.0,15,8,0,23
36.811217959013,16.497335138821878,1.8467166200173746,18.467166200173743,18,12,10,40
62.845590498279115,30.310483912886827,21.411993222865007,11.123113362527276,17,13,20,50
21.31930061151061,17.61159615733485,3.7077044541757584,0.0,10,6,0,16
53.35322314116602,18.719099596403417,14.171949896872222,20.462173647890374,16,12,0,28
14.527504077470013,14.527504077470013,0.0,0.0,12,9,5,26
32.34972136268349,21.226608000156215,6.488482794807577,4.634630567719698,5,11,0,16
87.40913250719349,29.568943022051673,22.616997170472125,35.2231923146697,18,15,30,63
20.485067109321065,15.386973484829399,5.098093624491668,0.0,15,11,0,26
25.49046812245834,17.61159615733485,7.878871965123487,0.0,12,9,5,26
36.225625939598515,20.159030334588298,10.003729338968627,6.062866266041593,22,16,15,53
63.58430996511121,24.17567923584085,20.462173647890374,18.94645708137998,11,14,10,35
28.316321506933075,13.542588546794079,8.618010893414414,6.155722066724581,17,13,20,50
32.44241397403788,20.021604052549097,12.420809921488791,0.0,9,7,0,16
38.16547681369241,22.160599440208493,16.00487737348391,0.0,14,10,0,24
56.82057076024349,21.875456279636975,20.114296663903488,14.830817816703034,20,15,30,65
19.372755773068334,15.201588262120609,4.171167510947728,0.0,15,12,0,27
26.0,17.0,9.0,0.0,6,3,10,19
39.48705243697183,21.78276366828258,17.70428876868925,0.0,19,14,10,43
63.81166745008777,24.17567923584085,20.689531132866936,18.94645708137998,14,16,15,45
13.255043423678336,13.255043423678337,0.0,0.0,8,2,30,40
29.939713467469243,15.572358707538186,0.4634630567719698,13.903891703159093,11,5,0,16
26.973549904128642,13.996584314513488,3.7077044541757584,9.269261135439397,13,10,0,23
6.0,6.0,0.0,0.0,10,1,15,26
95.33857203350405,34.255194403135,24.70618003411949,36.37719759624956,22,16,25,63
53.483636751485314,25.675853345167127,13.903891703159093,13.903891703159093,10,13,0,23
62.845590498279115,30.310483912886827,21.411993222865007,11.123113362527276,12,10,0,22
76.31632912379854,32.05740538169492,21.523175244447653,22.735748497655972,11,15,20,46
81.16662213663182,28.798614763697564,25.085109175747093,27.28289819718717,20,15,20,55
43.56552733656516,15.294280873475003,9.732724192211366,18.538522270878794,9,0,0,9
21.31930061151061,17.61159615733485,3.7077044541757584,0.0,9,0,0,9
53.35322314116602,18.719099596403417,14.171949896872222,20.462173647890374,12,12,10,34
39.0,16.0,13.0,10.0,10,4,0,14
56.079029869408345,29.476250410697276,17.33351832327167,9.269261135439397,15,14,15,44
99.45917198326472,31.23741002643077,23.729308506724855,44.4924534501091,21,16,25,62
33.46203269893622,21.875456279636975,11.586576419299245,0.0,10,8,0,18
33.24089916031274,19.69831061351866,13.542588546794079,0.0,16,10,0,26
64.64531156166848,25.615609974025727,16.29395308998678,22.735748497655972,17,12,10,39
32.44241397403788,20.021604052549097,12.420809921488791,0.0,11,5,10,26
28.931893713605536,15.389305166811454,7.386866480069498,6.155722066724581,5,0,0,5
56.82057076024349,21.875456279636975,20.114296663903488,14.830817816703034,13,11,0,24
21.545027233536036,15.389305166811454,6.155722066724581,0.0,6,0,0,6
34.852421869252126,20.021604052549097,10.196187248983335,4.634630567719698,19,14,15,48
51.3827916047025,22.508391012679414,13.717234926919105,15.157165665103982,14,2,20,36
35.08761578033012,20.92945502686358,14.158160753466538,0.0,15,7,0,22
42.82398644573001,21.504685834219398,12.050039476071214,9.269261135439397,13,9,0,22
32.44241397403788,21.31930061151061,11.123113362527276,0.0,8,6,0,14
33.27664747622743,18.909292716296367,0.4634630567719698,13.903891703159093,7,0,0,7
31.14471741507637,14.92351042805743,1.3903891703159095,14.830817816703034,16,9,0,25
31.39418254029537,19.082738406846204,6.155722066724581,6.155722066724581,8,0,0,8
54.50325547638364,22.524304559117734,13.440428646387124,18.538522270878794,14,3,15,32
29.0,18.0,11.0,0.0,4,0,0,4
63.81166745008777,24.17567923584085,20.689531132866936,18.94645708137998,18,13,0,31
13.255043423678336,13.255043423678337,0.0,0.0,12,0,0,12
29.939713467469243,15.572358707538186,0.4634630567719698,13.903891703159093,17,11,0,28
36.811217959013,16.497335138821878,1.8467166200173746,18.467166200173743,15,1,25,41
46.43018772362977,24.118839864596712,14.732765026481069,7.578582832551991,6,0,0,6
22.776171646880954,15.389305166811454,7.386866480069498,0.0,17,15,0,32
36.869805480365436,19.817994107123454,9.47322854068999,7.578582832551991,12,14,10,36
43.97337482652449,19.409832817610095,10.659650305755305,13.903891703159093,22,16,5,43
48.79470556738598,22.451551641435273,6.146230677199664,20.196923248751055,19,1,5,25
22.776171646880954,16.62044958015637,6.155722066724581,0.0,14,2,0,16
35.06098024479952,23.93786688227224,11.123113362527276,0.0,15,14,10,39
26.880857292774248,13.903891703159093,3.7077044541757584,9.269261135439397,10,3,10,23
59.567661063858644,26.104428566725332,16.373528209728576,17.08970428740474,12,11,15,38
26.61598290792259,13.732392092584206,5.305007982786393,7.578582832551991,11,7,0,18
34.9636530028774,16.42513073199861,9.269261135439397,9.269261135439397,6,12,5,23
53.0340775864165,20.591663612378618,9.269261135439397,23.17315283859849,16,12,5,33
32.95222333648705,21.36564691718781,11.586576419299245,0.0,7,2,20,29
32.59072215220491,19.150293505817793,8.805798078667426,4.634630567719698,9,5,5,19
56.47760809823223,21.829109973959778,15.600166490944503,19.048331633327958,10,3,0,13
91.86379180477896,33.04262114992668,23.1260455135324,35.69512514131988,18,16,30,64
19.082738406846204,11.695871926776706,1.2311444133449163,6.155722066724581,13,1,30,44
76.47169007186586,26.290103846122854,18.275752500699127,31.905833725043884,11,10,0,21
27.08517709358816,16.62044958015637,10.46472751343179,0.0,9,0,0,9
43.78147302365285,23.698228517390074,8.71537025743479,11.367874248827986,19,14,0,33
11.695871926776706,11.695871926776706,0.0,0.0,13,4,10,27
41.704941327533604,23.141202679197505,10.985155815784111,7.578582832551991,14,8,0,22
92.02673133567883,24.89943389634957,18.131759426880638,48.99553801244863,22,16,30,68
36.676551618135356,21.89831509465898,10.988945107200387,3.7892914162759954,12,15,20,47
46.70317223091139,17.968462711049266,10.196187248983335,18.538522270878794,8,0,0,8
26.4696048869157,14.773732960138997,11.695871926776706,0.0,15,10,0,25
30.16303812695045,16.62044958015637,13.542588546794079,0.0,16,11,10,37
35.06098024479952,23.93786688227224,11.123113362527276,0.0,19,14,0,33
32.59072215220491,14.515662938098094,4.171167510947728,13.903891703159093,14,6,15,35
45.51317920089098,24.759230113947357,13.175366254391635,7.578582832551991,21,15,20,56
51.10996262273063,24.130207738845538,15.611880635057103,11.367874248827986,15,0,0,15
58.3339135413593,25.56099584303825,13.908474912817287,18.864442785503755,18,15,0,33
26.4696048869157,16.62044958015637,3.693433240034749,6.155722066724581,10,0,0,10
42.20189777787954,23.07814993690494,12.641121454203548,6.48262638677105,19,16,15,50
99.78706797156678,32.44878637898249,25.428102002109444,41.91017959047484,10,4,0,14
28.931893713605536,16.62044958015637,6.155722066724581,6.155722066724581,11,2,0,13
28.760721849534807,20.803209875355215,4.168220557903595,3.7892914162759954,4,0,0,4
40.50667116187016,19.18737055035955,5.561556681263638,15.757743930246974,14,0,0,14
49.935671057297405,28.222113974807762,15.230930695718582,6.48262638677105,11,0,0,11
52.04212831113452,25.46403831737469,18.241648877952642,8.33644111580719,16,13,0,29
64.17165013463398,23.512553237992552,11.860482132943865,28.798614763697564,18,13,0,31
56.793899747144614,25.266995163728343,15.611880635057103,15.915023948359181,8,0,0,8
20.92945502686358,17.23602178682883,3.693433240034749,0.0,7,0,0,7
13.231870270839737,11.37801804375186,1.8538522270878792,0.0,10,0,0,10
20.577759720675456,16.40659220972773,4.171167510947728,0.0,20,14,20,54
34.69854149883929,16.50994270071451,3.0314331330207964,15.157165665103982,16,0,0,16
35.88594448585362,14.566643874343011,2.780778340631819,18.538522270878794,5,0,0,5
89.722842154583,33.05019973275923,24.766808696779908,31.905833725043884,22,16,15,53
15.308737321755022,11.140516763851426,0.37892914162759955,3.7892914162759954,14,0,0,14
32.62532695364028,20.313882820191118,12.311444133449163,0.0,7,0,0,7
33.8328031443538,19.465448384422732,14.367354759931064,0.0,15,14,20,49
12.311444133449164,11.080299720104247,1.2311444133449163,0.0,6,0,0,6
27.807783406318187,18.075059214106822,9.732724192211366,0.0,13,0,0,13
33.24089916031274,19.082738406846204,14.158160753466538,0.0,17,13,0,30
29.547465920277993,16.62044958015637,6.771294273397039,6.155722066724581,8,0,0,8
32.02529722294311,15.340627179152202,7.415408908351517,9.269261135439397,13,0,0,13
40.41861318108349,19.562775626344845,11.586576419299245,9.269261135439397,9,0,0,9
47.479821445938214,26.05516777831374,9.639957363006133,11.784696304618347,11,1,15,27
35.08761578033012,13.542588546794079,9.233583100086872,12.311444133449163,15,0,0,15
54.004981264765476,26.722083067578318,12.125732532083186,15.157165665103982,14,0,0,14
82.14425932203103,29.954348645661742,23.73233214013656,28.457578536232724,17,0,0,17
47.025106475985105,26.97217630105254,16.263638758656572,3.7892914162759954,12,0,0,12
37.79439258593678,22.637226920832795,7.578582832551991,7.578582832551991,12,3,20,35
74.3233115243301,27.207582945278094,20.82867858069538,26.287049998356604,12,0,0,12
32.07627815918803,20.953164796660754,11.123113362527276,0.0,9,0,0,9
48.07852948970983,29.094179494167093,15.195058579266743,3.7892914162759954,21,15,0,36
51.10996262273063,24.130207738845538,15.611880635057103,11.367874248827986,11,5,15,31
58.3339135413593,25.56099584303825,13.908474912817287,18.864442785503755,21,15,20,56
65.13413015436808,30.155181090724373,19.404961342749374,15.573987720894342,16,12,15,43
99.78706797156678,32.44878637898249,25.428102002109444,41.91017959047484,14,9,30,53
78.30191782592716,27.999074274863332,22.52733746976079,27.775506081303046,12,14,10,36
18.467166200173747,13.542588546794079,4.924577653379665,0.0,9,3,10,22
28.760721849534807,20.803209875355215,4.168220557903595,3.7892914162759954,16,13,0,29
39.90881719621878,22.857005822976806,13.262519956965985,3.7892914162759954,10,4,0,14
49.935671057297405,28.222113974807762,15.230930695718582,6.48262638677105,7,11,5,23
52.04212831113452,25.46403831737469,18.241648877952642,8.33644111580719,13,9,30,52
56.793899747144614,25.266995163728343,15.611880635057103,15.915023948359181,13,8,30,51
20.92945502686358,17.23602178682883,3.693433240034749,0.0,6,0,0,6
48.47261579700253,26.11579644097416,10.988945107200387,11.367874248827986,12,6,5,23
89.722842154583,33.05019973275923,24.766808696779908,31.905833725043884,12,16,0,28
33.8328031443538,19.465448384422732,14.367354759931064,0.0,18,13,0,31
68.83900960112179,29.89139026940131,22.027964462248026,16.919654869472442,22,16,0,38
33.24089916031274,19.082738406846204,14.158160753466538,0.0,9,2,20,31
32.02529722294311,15.340627179152202,7.415408908351517,9.269261135439397,10,0,0,10
40.41861318108349,19.562775626344845,11.586576419299245,9.269261135439397,17,12,15,44
47.479821445938214,26.05516777831374,9.639957363006133,11.784696304618347,14,10,0,24
35.08761578033012,13.542588546794079,9.233583100086872,12.311444133449163,15,10,0,25
20.92945502686358,12.927016340121622,8.002438686741955,0.0,8,0,0,8
37.79439258593678,22.637226920832795,7.578582832551991,7.578582832551991,11,7,0,18
74.3233115243301,27.207582945278094,20.82867858069538,26.287049998356604,19,15,20,54
32.07627815918803,20.953164796660754,11.123113362527276,0.0,19,14,10,43
37.739796712941505,20.12820055560665,8.342335021895456,9.269261135439397,6,1,0,7
21.059761299718307,14.57127850491073,6.488482794807577,0.0,4,0,0,4
48.07852948970983,29.094179494167093,15.195058579266743,3.7892914162759954,15,11,5,31
42.091449051993756,22.38713368735858,8.33644111580719,11.367874248827986,8,7,0,15
21.545027233536036,16.00487737348391,5.540149860052123,0.0,9,5,5,19
26.4696048869157,16.62044958015637,9.84915530675933,0.0,10,6,10,26
18.467166200173747,11.695871926776706,6.771294273397039,0.0,12,4,5,21
32.178240031677866,17.34742221497483,0.9269261135439396,13.903891703159093,10,10,0,20
31.602690411741804,16.06659560501022,7.9575119741795906,7.578582832551991,18,15,10,43
35.11659581161215,15.187684370417449,6.025019738035607,13.903891703159093,17,12,5,34
95.22005768208658,35.43079451689717,25.00997260016271,34.779290565026685,22,16,20,58
24.007316060225868,14.773732960138997,9.233583100086872,0.0,12,8,0,20
36.84076575601988,22.903119024462118,10.696333538172233,3.241313193385525,15,13,5,33
33.8564713669852,15.389305166811454,6.155722066724581,12.311444133449163,15,11,10,36
56.26919703717271,28.24480316716146,18.30045428985467,9.723939580156575,16,16,20,52
22.160599440208493,15.389305166811454,6.771294273397039,0.0,7,3,25,35
19.082738406846204,14.773732960138997,4.309005446707207,0.0,14,12,5,31
30.778610333622908,17.23602178682883,1.2311444133449163,12.311444133449163,20,15,10,45
11.95734686471682,11.957346864716822,0.0,0.0,8,2,10,20
41.859983287644305,17.29644127872991,10.659650305755305,13.903891703159093,17,13,5,35
45.41937956365304,19.928911441194703,11.586576419299245,13.903891703159093,14,10,0,24
27.08517709358816,17.851593993501286,9.233583100086872,0.0,13,9,0,22
12.0,12.0,0.0,0.0,5,1,20,26
72.37925534228778,20.64405963587162,23.27761717018344,28.457578536232724,11,14,25,50
42.272465408171364,21.416627853432725,11.586576419299245,9.269261135439397,19,14,25,58
39.80220731557676,17.555980590522214,8.342335021895456,13.903891703159093,11,11,10,32
51.29053997213256,20.154485436471195,17.10116840830203,14.034886127359322,14,9,0,23
37.94835508848888,18.329963895331403,10.349130057718085,9.269261135439397,9,0,0,9
56.59396450185054,26.831992546247132,13.785453267779495,15.976518687823917,13,8,0,21
60.03753319947687,26.786501021655013,20.708477589948316,12.542554587873546,13,15,20,48
39.8578228823894,19.928911441194703,15.294280873475003,4.634630567719698,7,0,0,7
52.41347886992956,23.406453078336824,17.639151542764758,11.367874248827986,15,4,0,19
42.993300409067444,25.145737838407506,14.058271154383943,3.7892914162759954,16,9,0,25
15.389305166811454,12.927016340121622,2.4622888266898326,0.0,12,0,0,12
106.67992124241809,31.974040970536848,25.71034225943263,48.99553801244863,22,16,30,68
40.37055582361672,22.543333259996324,14.585909370234862,3.241313193385525,19,13,0,32
9.233583100086873,9.233583100086872,0.0,0.0,4,0,0,4
20.92945502686358,11.695871926776706,3.0778610333622907,6.155722066724581,16,13,0,29
59.84436548947695,23.70048207003496,18.93251036256485,17.21137305687714,10,5,10,25
75.5357350920457,27.73761316714029,18.99950716120784,28.798614763697564,17,10,5,32
20.69826011543617,12.819388150312685,3.2442413974037887,4.634630567719698,15,3,10,28
81.0620016533786,29.871942390240996,24.254746626103884,26.93531263703371,6,7,5,18
35.39956041085035,23.360981581341512,12.038578829508838,0.0,15,6,0,21
67.80936989425894,27.33594827701503,21.526964535863932,18.94645708137998,20,14,10,44
26.69176873624811,16.081752770675322,6.820724549296792,3.7892914162759954,8,1,30,39
53.542687711979816,24.92974822767977,12.622129707615342,15.990809776684703,14,10,5,29
30.014977308322162,17.889244776238975,8.33644111580719,3.7892914162759954,8,0,0,8
29.547465920277993,12.927016340121622,4.309005446707207,12.311444133449163,11,0,0,11
64.80446180115207,28.60536090146749,20.625113178790244,15.573987720894342,12,14,10,36
20.92945502686358,16.62044958015637,4.309005446707207,0.0,9,0,0,9
32.33581747098033,18.431925767821237,9.269261135439397,4.634630567719698,14,0,0,14
24.62288826689833,11.695871926776706,0.6155722066724582,12.311444133449163,10,0,0,10
43.10206427979319,20.39237449796667,13.440428646387124,9.269261135439397,12,11,0,23
21.545027233536036,14.773732960138997,6.771294273397039,0.0,6,0,0,6
39.63219892283064,18.033237850057464,6.441795407669193,15.157165665103982,17,11,0,28
20.31388282019112,12.927016340121622,7.386866480069498,0.0,17,12,10,39
30.01850218712048,18.431925767821237,6.951945851579547,4.634630567719698,11,0,0,11
62.74534079755699,27.962808919336922,14.97810826663451,19.80442361158556,11,2,20,33
59.88217225140954,24.06957907618512,15.615669926473378,20.196923248751055,18,16,30,64
30.16303812695045,15.389305166811454,8.618010893414414,6.155722066724581,19,12,10,41
49.760974878536366,20.96236011483881,6.062866266041593,22.735748497655972,10,0,0,10
68.43460297794448,30.693260471835565,22.584176841004933,15.157165665103982,10,16,25,51
42.17513816624925,23.17315283859849,14.367354759931064,4.634630567719698,18,15,5,38
50.0,13.0,7.0,30.0,13,15,5,33
64.88482794807577,26.880857292774248,19.465448384422732,18.538522270878794,7,13,5,25
48.0,22.0,16.0,10.0,12,14,25,51
53.55478198050386,23.39174385355341,17.851593993501286,12.311444133449163,22,16,25,63
21.0,10.0,1.0,10.0,15,14,25,54
54.22517764232046,26.510086847356675,18.445829659524396,9.269261135439397,13,12,10,35
43.10206427979319,23.63661589537046,10.196187248983335,9.269261135439397,18,14,15,47
60.620967825773654,23.543923284016063,11.123113362527276,25.95393117923031,14,15,20,49
11.695871926776706,11.695871926776706,0.0,0.0,8,10,0,18
13.54258854679408,13.542588546794079,0.0,0.0,17,13,5,35
36.31876019367503,19.082738406846204,17.23602178682883,0.0,16,12,10,38
23.39174385355341,12.927016340121622,4.309005446707207,6.155722066724581,11,5,10,26
35.08761578033012,20.313882820191118,14.773732960138997,0.0,15,10,0,25
79.25218270800683,29.383557799342885,22.060841502345763,27.807783406318187,22,16,30,68
74.42168341566055,29.329115561976206,22.356819356028375,22.735748497655972,19,15,20,54
46.16791550043436,21.545027233536036,18.467166200173743,6.155722066724581,20,16,30,66
48.014632120451736,20.92945502686358,14.773732960138997,12.311444133449163,6,7,0,13
11.080299720104247,11.080299720104247,0.0,0.0,7,1,30,38
28.734709519862125,15.294280873475003,4.171167510947728,9.269261135439397,12,13,5,30
6.0,6.0,0.0,0.0,10,4,5,19
23.39174385355341,17.23602178682883,6.155722066724581,0.0,12,11,0,23
16.00487737348391,12.311444133449163,3.693433240034749,0.0,5,6,0,11
33.56862920199377,20.591663612378618,8.342335021895456,4.634630567719698,10,12,5,27
19.082738406846204,9.233583100086872,3.693433240034749,6.155722066724581,9,7,0,16
38.999387256312545,21.947575883070567,9.47322854068999,7.578582832551991,10,0,10,20
8.618010893414414,6.771294273397039,1.8467166200173746,0.0,13,0,0,13
86.441315788088,34.66822716750909,24.41440459506624,27.358684025512687,16,15,30,61
46.74469891118068,23.42161024400193,13.470930984861162,9.85215768231759,21,15,30,66
42.221484471926445,21.36564691718781,11.586576419299245,9.269261135439397,15,11,0,26
44.414284690170945,22.81532361739777,14.020378240221184,7.578582832551991,15,6,0,21
103.21637733016867,32.40664930746848,26.37132414138463,44.438403881315544,12,16,25,53
30.778610333622908,17.851593993501286,12.927016340121622,0.0,10,0,0,10
19.69831061351866,12.927016340121622,6.771294273397039,0.0,14,0,0,14
43.36086167644622,21.76190060367304,10.231086823945187,11.367874248827986,17,11,10,38
96.99305599886846,31.340257266844638,25.687407057580284,39.965391674443524,22,16,25,63
42.26575645714245,24.077157659017676,14.399307381848782,3.7892914162759954,6,5,5,16
82.59838410704333,33.126220836400066,19.58725562762873,29.88490764301454,17,14,0,31
39.39435982561743,21.31930061151061,8.805798078667426,9.269261135439397,20,14,0,34
22.160599440208493,13.542588546794079,8.618010893414414,0.0,8,10,0,18
33.24089916031274,19.082738406846204,14.158160753466538,0.0,9,0,0,9
39.29874127819834,26.16505722938575,13.133684048812599,0.0,18,13,15,46
9.84915530675933,9.84915530675933,0.0,0.0,8,0,0,8
37.54990460701995,16.62044958015637,8.618010893414414,12.311444133449163,19,13,15,47
24.007316060225868,16.62044958015637,7.386866480069498,0.0,12,0,0,12
46.90763844208055,23.94074316803174,15.388312441496817,7.578582832551991,13,4,15,32
10.46472751343179,10.46472751343179,0.0,0.0,12,0,0,12
34.5393912593557,17.86650902774132,5.305007982786393,11.367874248827986,14,2,30,46
30.778610333622908,11.080299720104247,7.386866480069498,12.311444133449163,16,0,10,26
37.54050759852955,14.830817816703034,4.171167510947728,18.538522270878794,13,1,25,39
28.316321506933075,16.62044958015637,11.695871926776706,0.0,18,12,5,35
52.33390375018778,21.74674343800794,14.179528479704777,16.407631832475058,11,9,0,20
19.082738406846204,14.158160753466538,4.924577653379665,0.0,4,0,0,4
9.84915530675933,9.84915530675933,0.0,0.0,5,0,0,5
19.69831061351866,12.311444133449163,1.2311444133449163,6.155722066724581,7,0,0,7
32.12725909543294,19.150293505817793,8.342335021895456,4.634630567719698,15,8,0,23
9.776371853992067,9.776371853992067,0.0,0.0,11,0,0,11
20.31388282019112,11.080299720104247,3.0778610333622907,6.155722066724581,7,3,0,10
83.6789223456228,32.8493672876966,23.470871032413516,27.358684025512687,20,13,0,33
45.38055400132132,19.07908228094964,9.893839887896624,16.407631832475058,6,0,0,6
57.99889441752038,28.783457598032467,15.573987720894342,13.641449098593585,10,0,0,10
50.82197647509365,21.341289256466407,8.26065528748167,21.220031931145574,3,10,0,13
88.61413645480062,22.802382393180917,21.31930061151061,44.4924534501091,17,0,0,17
101.96225342915447,35.930061209128986,26.130953606639263,39.901238613386234,18,16,30,64
100.14685373603258,36.69814797551091,26.789453543331366,36.659252217190286,11,7,0,18
88.87025158592093,27.91570986370526,24.842594525105426,36.11194719711023,14,4,0,18
54.68864069909243,19.00198532765076,12.513502532843185,23.17315283859849,4,0,0,4
83.23368149294689,34.08564954164218,25.810576958928934,23.33745499237578,10,0,0,10
80.78324871874746,30.202556335966324,23.9370979331521,26.643594449629017,14,0,0,14
83.58040076879962,34.14530495206299,24.766808696779908,24.66828711995673,12,0,0,12
79.77595218685853,28.83271838644405,19.45422213116096,31.48901166925352,7,0,0,7
65.9526171002837,30.011188016905887,16.16132789041712,19.780101192960696,15,0,0,15
66.73868017516365,25.212390288395156,18.353137048170005,23.17315283859849,6,0,0,6
79.43162111710568,26.32270444348385,26.465322223992814,26.643594449629017,16,0,0,16
83.48650392203095,32.31913385124707,24.880320072427285,26.287049998356604,14,0,0,14
59.582818229523745,30.769046300161083,20.81836704102032,7.995404888342351,13,0,0,13
103.21637733016867,32.40664930746848,26.37132414138463,44.438403881315544,16,1,30,47
101.50753845920136,35.47534623917587,26.130953606639263,39.901238613386234,22,16,30,68
71.89422604100446,30.382538575700934,22.148408328133193,19.363279137170338,15,0,0,15
96.99305599886846,31.340257266844638,25.687407057580284,39.965391674443524,20,12,15,47
75.26329235041189,28.056807001945103,22.215960627464383,24.990524721002394,6,0,0,6
88.8096229232605,31.686054822899877,24.800912319526393,32.32265578083424,17,2,20,39
79.34734697407765,30.980471502378848,20.783300195987987,27.583575275710814,9,0,0,9
83.16237260269241,33.68048539246899,25.723061502707527,23.758825707515896,5,0,0,5
75.0810151970591,27.25162773819182,18.167751825461217,29.661635633406068,19,11,0,30
93.31509041721266,32.402230900576036,24.87669814785191,36.03616136878472,13,9,0,22
76.74948220143821,29.84702085611486,23.729308506724855,23.17315283859849,22,15,20,57
53.02017369471334,17.33351832327167,12.513502532843185,23.17315283859849,7,0,0,7
93.04605072665707,34.70990937308812,25.255627289479513,33.08051406408944,17,15,20,52
102.31529226240748,35.2006612801668,27.149239307797153,39.965391674443524,16,11,0,27
90.71787365647408,33.32718225438997,26.56580293298776,30.82488846909634,19,12,15,46
105.52095101066578,34.51674419636245,27.149239307797153,43.854967506506156,11,8,0,19
88.15067339802864,31.052024803721977,23.729308506724855,33.369340087581826,18,10,0,28
64.37248257969661,25.869492498916227,18.798674716145214,19.70431536463518,18,9,0,27
63.401746166405474,26.510086847356675,18.353137048170005,18.538522270878794,15,0,0,15
81.8486945915615,28.950186420348608,18.79488542472894,34.10362274648396,7,0,0,7
114.01967420372262,36.01423089170657,26.37132414138463,51.634119170631415,19,14,15,48
70.17009844659889,26.957019135387434,19.2268646461844,23.98621466502705,17,0,0,17
88.79952167750942,32.16433613997471,23.265845449952884,33.369340087581826,15,0,0,15
90.59470375512544,32.34182304360077,25.774922513801695,32.47795819772296,10,0,0,10
99.79098944762835,33.53143974262628,25.676238636686143,40.58331106831591,5,0,0,5
95.22489329101577,29.76867336626422,24.456086800645274,41.00013312410627,14,0,0,14
56.73251277945682,23.93786688227224,13.746314263856625,19.048331633327958,12,0,0,12
67.01675800922683,26.880857292774248,16.962747877854095,23.17315283859849,12,5,15,32
48.75631357241122,23.17315283859849,11.67926903065364,13.903891703159093,14,0,0,14
77.4803505746876,31.440737975839593,22.280786891332095,23.758825707515896,12,0,0,12
62.75289788692471,18.538522270878794,14.552739982639851,29.661635633406068,15,0,0,15
54.027717013263135,27.38520906542662,14.857811643218179,11.784696304618347,8,0,0,8
67.90031288824956,27.15785158045006,20.280287659909128,20.462173647890374,12,0,0,12
76.31632912379855,26.67661157058301,15.536094806731581,34.10362274648396,16,0,0,16
39.63072598457113,20.383105236831234,14.10318081757104,5.144439930168865,8,0,0,8
66.96056861701311,29.609523126780623,18.404588408852508,18.94645708137998,9,0,0,9
88.85130512883954,32.44391310615507,24.842594525105426,31.564797497579043,8,0,0,8
59.431246572872716,24.152943487343194,16.33184600414954,18.94645708137998,9,0,0,9
97.43783947812094,32.92515311602212,23.512553237992552,41.00013312410627,13,13,0,26
86.8050877640505,33.65648635936339,25.373095323384064,27.775506081303046,11,0,0,11
76.02834297616157,24.058211201936295,21.92105084315663,30.049080931068644,10,0,0,10
76.08518234740572,27.52920213924511,21.197296182647918,27.358684025512687,13,0,0,13
70.07561418392183,28.827402131216523,17.148133100562884,24.10007895214243,9,0,0,9
79.11073111096051,31.119847969694423,20.763852316827673,27.22703082443841,13,3,15,31
70.50355609123118,30.8296749628215,16.9381326307537,22.735748497655972,11,0,0,11
69.51945851579546,26.23200901329349,20.114296663903488,23.17315283859849,8,0,0,8
81.27272229628755,32.36812727782956,21.12908893715495,27.775506081303046,12,0,0,12
58.95948698768271,25.898092415150344,16.85482860560473,16.206565966927624,10,0,0,10
73.85980373767596,33.09704901765959,24.556188753088733,16.206565966927624,11,6,0,17
82.37919538984015,29.935402188580365,23.645178437562212,28.798614763697564,21,14,15,50
35.08761578033012,16.00487737348391,12.927016340121622,6.155722066724581,5,0,0,5
29.67067756310156,21.111828266053035,8.558849297048527,0.0,12,2,20,34
70.63239199938455,29.480687218627246,22.205247699377335,18.94645708137998,16,15,20,51
87.608417544301,28.419685622069967,25.085109175747093,34.10362274648396,20,15,20,55
24.007316060225868,17.851593993501286,6.155722066724581,0.0,22,16,5,43
35.08761578033012,20.313882820191118,14.773732960138997,0.0,18,16,5,39
23.39174385355341,16.62044958015637,6.771294273397039,0.0,13,3,0,16
61.08443088254562,26.880857292774248,15.665051318892578,18.538522270878794,9,14,0,23
10.0,10.0,0.0,0.0,14,13,0,27
32.62532695364028,18.467166200173743,8.002438686741955,6.155722066724581,17,14,0,31
19.082738406846204,11.080299720104247,1.8467166200173746,6.155722066724581,8,0,0,8
11.080299720104247,11.080299720104247,0.0,0.0,10,1,5,16
11.0,11.0,0.0,0.0,15,13,0,28
18.0,12.0,6.0,0.0,7,0,0,7
27.946978182929602,20.5601117028601,7.386866480069498,0.0,11,4,0,15
9.233583100086873,9.233583100086872,0.0,0.0,7,1,20,28
44.93677108708945,22.77617164688095,16.00487737348391,6.155722066724581,17,14,10,41
31.42279524913955,17.055440489208486,0.4634630567719698,13.903891703159093,15,13,0,28
63.67982400046865,28.178553851735764,21.597378445573792,13.903891703159093,18,15,5,38
70.63239199938455,29.480687218627246,22.205247699377335,18.94645708137998,22,16,20,58
22.160599440208493,16.62044958015637,5.540149860052123,0.0,8,0,0,8
63.21636094369668,22.431611947763336,22.24622672505455,18.538522270878794,20,15,5,40
9.0,9.0,0.0,0.0,9,0,0,9
51.4618364778175,24.74600270823282,14.40438963613552,12.311444133449163,11,4,0,15
48.01477268157607,21.133915388801825,12.976965589615155,13.903891703159093,10,13,0,23
74.42168341566055,29.329115561976206,22.356819356028375,22.735748497655972,16,16,20,52
8.0,8.0,0.0,0.0,12,0,0,12
17.851593993501286,17.851593993501286,0.0,0.0,5,0,0,5
41.24821205270531,22.431611947763336,14.181969537222276,4.634630567719698,12,14,10,36
19.082738406846204,14.158160753466538,4.924577653379665,0.0,13,3,10,26
16.00487737348391,12.311444133449163,3.693433240034749,0.0,14,2,5,21
30.778610333622908,18.467166200173743,12.311444133449163,0.0,14,13,20,47
39.39662122703732,17.851593993501286,15.389305166811454,6.155722066724581,22,16,5,43
54.22517764232046,26.510086847356675,18.445829659524396,9.269261135439397,18,16,5,39
36.93433240034749,20.92945502686358,16.00487737348391,0.0,15,15,15,45
70.63239199938455,29.480687218627246,22.205247699377335,18.94645708137998,20,15,15,50
17.851593993501286,17.851593993501286,0.0,0.0,13,4,20,37
22.160599440208493,14.773732960138997,1.2311444133449163,6.155722066724581,8,0,0,8
42.47448226039961,20.313882820191118,16.00487737348391,6.155722066724581,9,13,20,42
33.24089916031274,20.313882820191118,12.927016340121622,0.0,16,14,0,30
10.103494637628941,10.103494637628943,0.0,0.0,10,0,0,10
15.0,15.0,0.0,0.0,7,0,0,7
28.734709519862125,15.294280873475003,4.171167510947728,9.269261135439397,11,3,0,14
39.39662122703732,22.160599440208493,17.23602178682883,0.0,17,14,0,31
36.33550365092243,17.33351832327167,7.415408908351517,11.586576419299245,12,0,0,12
15.389305166811454,15.389305166811454,0.0,0.0,5,2,15,22
66.20649962517419,32.16729483276693,22.67133054357928,11.367874248827986,19,16,15,50
33.24089916031274,19.082738406846204,14.158160753466538,0.0,14,2,20,36
77.95682361411527,30.591513919172584,21.07825969658607,26.287049998356604,14,15,20,49
75.16605295461034,31.499081613320534,23.57082954229954,20.096141798990253,16,12,5,33
57.5268265562063,29.25285157030436,21.79134859913088,6.48262638677105,17,13,30,60
114.01967420372262,36.01423089170657,26.37132414138463,51.634119170631415,12,11,15,38
36.93433240034749,19.69831061351866,11.080299720104247,6.155722066724581,10,8,0,18
47.911800667393685,25.433723986044484,14.899493848797215,7.578582832551991,17,13,30,60
45.08990783318604,24.49460380241441,13.756133192728168,6.839170838043458,15,11,15,41
24.007316060225868,18.467166200173743,5.540149860052123,0.0,5,9,0,14
52.723200403608956,27.538196891003416,18.054114487157374,7.1308890254481545,12,5,5,22
66.96056861701311,29.609523126780623,18.404588408852508,18.94645708137998,18,14,0,32
33.8564713669852,16.62044958015637,11.080299720104247,6.155722066724581,9,1,15,25
76.02834297616157,24.058211201936295,21.92105084315663,30.049080931068644,7,12,5,24
58.13295212336939,25.975883931791596,15.950502224650169,16.206565966927624,8,7,5,20
38.77331932954299,14.209777320628595,6.025019738035607,18.538522270878794,6,9,0,15
28.93863326484179,12.71742627782285,6.951945851579547,9.269261135439397,8,14,0,22
37.54990460701995,17.23602178682883,14.158160753466538,6.155722066724581,11,4,30,45
24.62288826689833,17.23602178682883,7.386866480069498,0.0,20,15,20,55
32.62532695364028,18.467166200173743,14.158160753466538,0.0,6,6,0,12
16.00487737348391,9.84915530675933,6.155722066724581,0.0,8,1,30,39
79.77595218685853,28.83271838644405,19.45422213116096,31.48901166925352,9,11,0,20
52.37132541523258,25.02700506568637,18.075059214106822,9.269261135439397,12,9,0,21
79.34734697407765,30.980471502378848,20.783300195987987,27.583575275710814,16,12,15,43
33.24089916031274,19.082738406846204,14.158160753466538,0.0,14,10,0,24
77.95682361411527,30.591513919172584,21.07825969658607,26.287049998356604,15,15,25,55
57.5268265562063,29.25285157030436,21.79134859913088,6.48262638677105,10,7,0,17
67.99626817084155,29.541328444515674,18.65051611474031,19.80442361158556,17,13,5,35
105.52095101066578,34.51674419636245,27.149239307797153,43.854967506506156,22,16,30,68
37.54990460701995,19.69831061351866,11.695871926776706,6.155722066724581,8,4,5,17
114.01967420372262,36.01423089170657,26.37132414138463,51.634119170631415,12,13,5,30
90.59470375512544,32.34182304360077,25.774922513801695,32.47795819772296,19,15,25,59
47.911800667393685,25.433723986044484,14.899493848797215,7.578582832551991,15,11,0,26
12.927016340121622,12.927016340121622,0.0,0.0,5,3,10,18
24.007316060225868,18.467166200173743,5.540149860052123,0.0,10,8,0,18
52.723200403608956,27.538196891003416,18.054114487157374,7.1308890254481545,17,14,10,41
82.18215223619379,35.551132067501385,25.676238636686143,20.954781532006255,18,14,10,42
66.96056861701311,29.609523126780623,18.404588408852508,18.94645708137998,14,10,0,24
11.080299720104247,11.080299720104247,0.0,0.0,7,2,25,34
25.238460473570786,18.467166200173743,6.771294273397039,0.0,6,3,15,24
13.54258854679408,13.542588546794079,0.0,0.0,10,4,5,19
22.160599440208493,14.773732960138997,1.2311444133449163,6.155722066724581,10,1,30,41
40.362997614270846,21.05512666915059,14.673240377400564,4.634630567719698,11,8,0,19
105.52095101066578,34.51674419636245,27.149239307797153,43.854967506506156,22,16,30,68
70.17009844659889,26.957019135387434,19.2268646461844,23.98621466502705,15,12,10,37
54.061862752477175,26.731109905850424,17.606813266470173,9.723939580156575,7,11,0,18
82.18215223619379,35.551132067501385,25.676238636686143,20.954781532006255,19,15,20,54
36.31876019367503,18.467166200173743,11.695871926776706,6.155722066724581,16,13,5,34
9.233583100086873,9.233583100086872,0.0,0.0,14,11,0,25
26.4696048869157,16.00487737348391,10.46472751343179,0.0,11,9,0,20
58.13295212336939,25.975883931791596,15.950502224650169,16.206565966927624,17,13,5,35
28.316321506933075,12.311444133449163,3.693433240034749,12.311444133449163,14,10,0,24
37.89737415224397,15.651147427189418,8.342335021895456,13.903891703159093,13,10,0,23
36.93433240034749,19.69831061351866,11.080299720104247,6.155722066724581,17,15,20,52
35.70318798700257,19.082738406846204,10.46472751343179,6.155722066724581,15,14,15,44
9.84915530675933,9.84915530675933,0.0,0.0,12,6,0,18
26.4696048869157,12.311444133449163,8.002438686741955,6.155722066724581,9,5,10,24
14.158160753466538,14.158160753466538,0.0,0.0,8,2,20,30
32.00975474696782,12.927016340121622,12.927016340121622,6.155722066724581,13,9,0,22
70.63145579706398,26.150914844234414,15.535614135896822,28.944926816932735,12,12,10,34
83.6789223456228,32.8493672876966,23.470871032413516,27.358684025512687,20,15,20,55
39.95515012431151,19.720353065647313,15.600166490944503,4.634630567719698,15,11,0,26
64.53542211059647,29.094179494167093,16.07796347925905,19.363279137170338,13,10,0,23
51.936028151478794,23.59212835773435,13.186734128640463,15.157165665103982,17,14,15,46
25.238460473570786,18.467166200173743,6.771294273397039,0.0,10,3,15,28
57.5268265562063,29.25285157030436,21.79134859913088,6.48262638677105,11,10,0,21
40.362997614270846,21.05512666915059,14.673240377400564,4.634630567719698,7,5,0,12
105.52095101066578,34.51674419636245,27.149239307797153,43.854967506506156,18,15,20,53
114.01967420372262,36.01423089170657,26.37132414138463,51.634119170631415,19,16,30,65
70.17009844659889,26.957019135387434,19.2268646461844,23.98621466502705,14,13,10,37
54.061862752477175,26.731109905850424,17.606813266470173,9.723939580156575,9,9,0,18
99.79098944762835,33.53143974262628,25.676238636686143,40.58331106831591,8,7,0,15
12.927016340121622,12.927016340121622,0.0,0.0,6,2,20,28
61.77302866813128,27.294266071435995,15.532305515315306,18.94645708137998,11,12,0,23
27.08517709358816,19.69831061351866,7.386866480069498,0.0,12,9,0,21
82.18215223619379,35.551132067501385,25.676238636686143,20.954781532006255,22,16,30,68
76.02834297616157,24.058211201936295,21.92105084315663,30.049080931068644,10,8,0,18
26.4696048869157,16.00487737348391,10.46472751343179,0.0,8,4,10,22
19.69831061351866,14.158160753466538,5.540149860052123,0.0,12,6,0,18
32.00975474696782,19.082738406846204,12.927016340121622,0.0,16,12,0,28
35.70318798700257,19.082738406846204,10.46472751343179,6.155722066724581,14,11,0,25
9.84915530675933,9.84915530675933,0.0,0.0,5,1,30,36
32.00975474696782,12.927016340121622,12.927016340121622,6.155722066724581,17,13,10,40
70.63145579706398,26.150914844234414,15.535614135896822,28.944926816932735,15,14,15,44
57.99889441752038,28.783457598032467,15.573987720894342,13.641449098593585,14,1,30,45
42.962986077737234,22.125672579635538,11.15567392951653,9.681639568585169,7,0,0,7
66.20649962517419,32.16729483276693,22.67133054357928,11.367874248827986,20,14,25,59
80.78324871874746,30.202556335966324,23.9370979331521,26.643594449629017,17,16,30,63
23.17315283859849,15.294280873475003,7.878871965123487,0.0,11,8,0,19
24.748927231623185,17.33351832327167,7.415408908351517,0.0,4,0,0,4
51.936028151478794,23.59212835773435,13.186734128640463,15.157165665103982,12,0,0,12
79.34734697407765,30.980471502378848,20.783300195987987,27.583575275710814,5,0,0,5
77.95682361411527,30.591513919172584,21.07825969658607,26.287049998356604,21,15,15,51
9.84915530675933,9.84915530675933,0.0,0.0,8,0,0,8
75.16605295461034,31.499081613320534,23.57082954229954,20.096141798990253,18,14,25,57
42.272465408171364,18.635849512800906,9.732724192211366,13.903891703159093,6,0,0,6
57.5268265562063,29.25285157030436,21.79134859913088,6.48262638677105,14,7,5,26
56.23308461753576,27.832345452547184,16.275006632905402,12.125732532083186,20,13,10,43
67.99626817084155,29.541328444515674,18.65051611474031,19.80442361158556,16,10,5,31
47.33203908070346,20.272709077076577,10.651698171151823,16.407631832475058,11,4,10,25
6.155722066724582,6.155722066724581,0.0,0.0,18,12,0,30
105.52095101066578,34.51674419636245,27.149239307797153,43.854967506506156,16,15,15,46
37.54990460701995,19.69831061351866,11.695871926776706,6.155722066724581,9,0,0,9
42.84172875241641,23.016156062460396,11.830167801613658,7.995404888342351,13,5,0,18
65.46804388000085,25.810576958928934,15.606923026151305,24.050543894920597,12,9,0,21
90.59470375512544,32.34182304360077,25.774922513801695,32.47795819772296,12,12,0,24
61.738925045384796,28.438632079151347,14.353835884853469,18.94645708137998,15,0,0,15
60.3482550956115,28.991868625927637,15.782398748789522,15.573987720894342,17,11,5,33
77.4803505746876,31.440737975839593,22.280786891332095,23.758825707515896,22,16,30,68
28.316321506933075,16.00487737348391,12.311444133449163,0.0,10,0,0,10
23.39174385355341,17.851593993501286,5.540149860052123,0.0,10,0,0,10
65.97535284878136,25.524666980035107,17.29811531529992,23.152570553446335,13,6,5,24
35.08761578033012,17.851593993501286,11.080299720104247,6.155722066724581,18,11,5,34
13.54258854679408,13.542588546794079,0.0,0.0,9,0,0,9
52.723200403608956,27.538196891003416,18.054114487157374,7.1308890254481545,7,0,0,7
66.96056861701311,29.609523126780623,18.404588408852508,18.94645708137998,14,2,15,31
39.23811261553793,22.569019675339828,12.87980152392211,3.7892914162759954,8,0,0,8
76.02834297616157,24.058211201936295,21.92105084315663,30.049080931068644,15,3,25,43
10.46472751343179,10.46472751343179,0.0,0.0,13,0,0,13
28.475170208069823,14.10781544813876,5.098093624491668,9.269261135439397,7,0,0,7
17.851593993501286,12.311444133449163,5.540149860052123,0.0,12,0,0,12
37.89737415224397,15.651147427189418,8.342335021895456,13.903891703159093,9,0,0,9
75.96989862656994,33.45683478212539,25.658235238839815,16.85482860560473,11,0,0,11
45.567687741820066,20.540682676133702,11.123113362527276,13.903891703159093,5,0,0,5
23.39174385355341,16.62044958015637,6.771294273397039,0.0,19,13,10,42
35.70318798700257,15.389305166811454,14.158160753466538,6.155722066724581,13,0,0,13
33.24089916031274,18.467166200173743,14.773732960138997,0.0,15,9,0,24
40.23848554943479,19.77631190154442,5.305007982786393,15.157165665103982,10,0,0,10
70.63145579706398,26.150914844234414,15.535614135896822,28.944926816932735,16,10,5,31
80.78324871874746,30.202556335966324,23.9370979331521,26.643594449629017,16,16,10,42
93.04605072665707,34.70990937308812,25.255627289479513,33.08051406408944,13,14,0,27
47.911800667393685,25.433723986044484,14.899493848797215,7.578582832551991,22,16,10,48
55.52045368950066,27.833156391601506,17.606813266470173,10.080484031428982,15,13,0,28
37.54990460701995,14.773732960138997,4.309005446707207,18.467166200173743,11,4,0,15
33.8564713669852,16.62044958015637,11.080299720104247,6.155722066724581,8,3,0,11
11.695871926776706,11.695871926776706,0.0,0.0,9,13,0,22
6.155722066724582,6.155722066724581,0.0,0.0,14,0,0,14
86.8050877640505,33.65648635936339,25.373095323384064,27.775506081303046,18,15,20,53
12.927016340121622,12.927016340121622,0.0,0.0,7,0,0,7
29.547465920277993,15.389305166811454,14.158160753466538,0.0,10,13,0,23
44.44838831291743,24.581133417382386,16.07796347925905,3.7892914162759954,20,15,20,55
35.70318798700257,15.389305166811454,14.158160753466538,6.155722066724581,12,2,20,34
33.24089916031274,18.467166200173743,14.773732960138997,0.0,17,14,0,31
28.316321506933075,20.313882820191118,8.002438686741955,0.0,5,0,0,5
83.6789223456228,32.8493672876966,23.470871032413516,27.358684025512687,12,12,5,29
80.78324871874746,30.202556335966324,23.9370979331521,26.643594449629017,14,14,20,48
57.5268265562063,29.25285157030436,21.79134859913088,6.48262638677105,17,15,15,47
37.54990460701995,19.69831061351866,11.695871926776706,6.155722066724581,15,13,10,38
90.59470375512544,32.34182304360077,25.774922513801695,32.47795819772296,20,15,15,50
54.061862752477175,26.731109905850424,17.606813266470173,9.723939580156575,18,14,20,52
99.79098944762835,33.53143974262628,25.676238636686143,40.58331106831591,22,16,25,63
61.77302866813128,27.294266071435995,15.532305515315306,18.94645708137998,10,10,0,20
67.90031288824956,27.15785158045006,20.280287659909128,20.462173647890374,19,16,25,60
35.686655371441674,19.928911441194703,6.488482794807577,9.269261135439397,13,11,5,29
59.431246572872716,24.152943487343194,16.33184600414954,18.94645708137998,5,2,15,22
58.13295212336939,25.975883931791596,15.950502224650169,16.206565966927624,11,7,0,18
49.35552069699484,28.135488765849267,9.85215768231759,11.367874248827986,16,13,10,39
53.644998580219266,25.979381949988227,16.297742381403054,11.367874248827986,10,5,5,20
36.4340369674937,23.55423544357159,9.090510107646114,3.7892914162759954,8,6,5,19
43.66285457848728,17.708923399256967,7.415408908351517,18.538522270878794,7,3,20,30
65.9971392843285,27.900476017672585,13.069658200969549,25.02700506568637,14,3,5,22
88.61413645480062,29.290865187988494,14.830817816703034,44.4924534501091,15,16,5,36
48.6302043271242,19.69831061351866,16.62044958015637,12.311444133449163,13,4,15,32
32.720491808101066,22.9877676158897,9.732724192211366,0.0,17,0,0,17
28.0,18.0,10.0,0.0,4,0,0,4
22.70968978182652,19.465448384422732,3.2442413974037887,0.0,7,0,0,7
44.02899039333713,23.17315283859849,11.586576419299245,9.269261135439397,15,0,0,15
37.54990460701995,19.69831061351866,11.695871926776706,6.155722066724581,10,0,0,10
47.39905991377928,19.082738406846204,16.00487737348391,12.311444133449163,8,0,0,8
44.58514606146349,24.192771563496827,11.123113362527276,9.269261135439397,21,15,20,56
28.808779272271043,15.88176293214942,0.6155722066724582,12.311444133449163,7,0,0,7
51.708065360486486,22.160599440208493,17.23602178682883,12.311444133449163,10,0,0,10
61.2698161052544,24.656234620268794,13.440428646387124,23.17315283859849,14,0,0,14
27.08517709358816,20.313882820191118,6.771294273397039,0.0,6,0,0,6
33.27664747622743,21.690071056928186,11.586576419299245,0.0,11,0,0,11
42.26783077760364,20.948530166093036,2.780778340631819,18.538522270878794,16,1,5,22
69.33407329308667,27.15893512683743,14.367354759931064,27.807783406318187,17,15,20,52
33.24089916031274,19.082738406846204,8.002438686741955,6.155722066724581,9,0,0,9
38.53482013769588,18.220937317504763,8.002438686741955,12.311444133449163,12,0,0,12
55.401498600521236,25.238460473570786,17.851593993501286,12.311444133449163,16,13,15,44
25.854032680243243,11.695871926776706,1.8467166200173746,12.311444133449163,15,0,0,15
46.0,21.0,15.0,10.0,13,0,0,13
46.16791550043436,22.77617164688095,17.23602178682883,6.155722066724581,18,2,20,40
62.75289788692471,18.538522270878794,14.552739982639851,29.661635633406068,18,14,5,37
28.0,18.0,10.0,0.0,10,0,0,10
42.35136781906512,22.037484998874,8.002438686741955,12.311444133449163,5,0,0,5
43.0,20.0,13.0,10.0,8,0,0,8
95.288004472317,32.62779919674668,23.729308506724855,38.930896768845464,22,16,5,43
35.21073022166461,14.896847401473487,8.002438686741955,12.311444133449163,12,0,0,12
27.0,15.0,12.0,0.0,9,0,0,9
36.984351930403186,11.957346864716822,6.488482794807577,18.538522270878794,11,0,0,11
44.0,20.0,14.0,10.0,19,13,15,47
40.0,15.0,15.0,10.0,14,0,0,14
45.55234329376191,22.77617164688095,16.62044958015637,6.155722066724581,20,14,5,39
27.0,17.0,10.0,0.0,12,0,0,12
13.66570298812857,13.66570298812857,0.0,0.0,11,0,0,11
59.41596387816652,27.437012960900613,13.440428646387124,18.538522270878794,15,16,30,61
24.499773825563835,19.57519617218417,4.924577653379665,0.0,22,16,30,68
4.0,4.0,0.0,0.0,6,11,15,32
38.83820415749106,18.445829659524396,6.488482794807577,13.903891703159093,14,12,0,26
21.690071056928183,15.201588262120609,1.8538522270878792,4.634630567719698,17,12,0,29
67.75829890006197,23.265845449952884,12.976965589615155,31.51548786049395,19,14,0,33
65.62636883891092,23.914693729433644,18.538522270878794,23.17315283859849,20,15,20,55
88.79952167750942,32.16433613997471,23.265845449952884,33.369340087581826,17,13,10,40
10.0,10.0,0.0,0.0,12,4,10,26
34.57434403518894,15.572358707538186,5.098093624491668,13.903891703159093,8,6,15,29
52.55671063794137,25.30508289974955,17.055440489208486,10.196187248983335,16,11,15,42
45.55234329376191,23.39174385355341,16.00487737348391,6.155722066724581,11,14,0,25
27.0,13.0,4.0,10.0,8,5,0,13
69.19246126119967,20.162819626004573,14.926018888711146,34.10362274648396,14,13,10,37
8.0,8.0,0.0,0.0,5,2,20,27
13.0,13.0,0.0,0.0,9,3,0,12
40.87508650736916,25.338991700637585,11.746803390455586,3.7892914162759954,13,2,0,15
28.931893713605536,15.389305166811454,13.542588546794079,0.0,12,7,5,24
60.35973428722526,23.88847823525132,17.930944585808724,18.540311466165203,18,13,0,31
45.97802764817367,27.82667376521473,11.66872749618789,6.48262638677105,16,11,0,27
38.20325976971347,21.982052782694527,11.586576419299245,4.634630567719698,9,6,0,15
83.23368149294689,34.08564954164218,25.810576958928934,23.33745499237578,20,14,20,54
40.10809293304626,22.496496775711414,12.976965589615155,4.634630567719698,14,9,0,23
59.582818229523745,30.769046300161083,20.81836704102032,7.995404888342351,17,14,20,51
21.875456279636975,14.92351042805743,6.951945851579547,0.0,16,10,10,36
35.403349702266624,19.488325753907446,8.33644111580719,7.578582832551991,12,8,0,20
22.246226725054548,16.22120698701894,6.025019738035607,0.0,9,0,0,9
32.01951246753216,21.257924845308334,10.761587622223827,0.0,15,15,0,30
22.776171646880954,16.00487737348391,6.771294273397039,0.0,9,0,0,9
88.8096229232605,31.686054822899877,24.800912319526393,32.32265578083424,22,16,15,53
61.90186457628465,32.496963185982935,18.03702714147374,11.367874248827986,18,12,30,60
25.30508289974955,13.718506480450307,2.317315283859849,9.269261135439397,11,5,25,41
60.82972470026616,26.4458743448325,18.177284388506024,16.206565966927624,13,10,10,33
65.37728711058604,30.850818974643428,17.606813266470173,16.919654869472442,14,12,30,56
74.77010745901592,32.87168720019771,21.61394742481321,20.28447283400501,19,13,0,32
26.880857292774248,17.148133100562884,9.732724192211366,0.0,12,9,0,21
31.978950917265916,18.538522270878794,8.805798078667426,4.634630567719698,16,11,0,27
28.215630896277517,12.921350022802518,1.3903891703159095,13.903891703159093,4,4,0,8
39.39662122703732,19.082738406846204,14.158160753466538,6.155722066724581,21,15,0,36
9.84915530675933,8.618010893414414,1.2311444133449163,0.0,7,0,0,7
33.383657377391515,18.60542085391514,3.410362274648396,11.367874248827986,13,3,10,26
36.557965918172975,19.409832817610095,12.513502532843185,4.634630567719698,6,0,5,11
27.700749300260618,15.389305166811454,0.0,12.311444133449163,10,0,5,15
46.0323121249208,24.774387279612462,13.679342012756344,7.578582832551991,8,1,10,19
14.158160753466538,11.080299720104247,3.0778610333622907,0.0,5,0,5,10
74.32695113025365,28.57125727872101,21.769479186505592,23.98621466502705,15,16,15,46
29.758962875328184,20.026238683116816,9.732724192211366,0.0,10,0,0,10
13.0,13.0,0.0,0.0,7,0,10,17
7.0,7.0,0.0,0.0,10,14,20,44
46.0,21.0,15.0,10.0,22,16,10,48
16.0,9.0,7.0,0.0,7,0,0,7
26.0,14.0,12.0,0.0,17,13,0,30
26.0,15.0,11.0,0.0,15,2,0,17
12.0,12.0,0.0,0.0,20,14,20,54
11.0,11.0,0.0,0.0,12,15,0,27
6.0,6.0,0.0,0.0,11,0,0,11
34.84138689766113,20.683226144194595,8.002438686741955,6.155722066724581,18,16,10,44
10.58784195476628,10.58784195476628,0.0,0.0,14,13,0,27
15.0,13.0,2.0,0.0,5,0,0,5
100.14685373603258,36.69814797551091,26.789453543331366,36.659252217190286,12,13,0,25
41.79588432152423,24.36514380665465,9.85215768231759,7.578582832551991,11,1,0,12
55.41838696303643,28.96913287742999,15.081379836778462,11.367874248827986,8,3,20,31
110.60183785826375,35.930061209128986,25.676238636686143,48.99553801244863,20,14,15,49
40.97739737560861,22.94037023413488,10.458444308921749,7.578582832551991,15,8,30,53
93.31509041721266,32.402230900576036,24.87669814785191,36.03616136878472,17,9,30,56
30.778610333622908,19.082738406846204,11.695871926776706,0.0,8,0,0,8
67.1500331878269,21.55348957577786,18.237859586536366,27.358684025512687,10,7,0,17
25.39777551110394,19.836218829840305,5.561556681263638,0.0,13,0,5,18
56.74463895873303,27.116169374871024,18.260595335034022,11.367874248827986,18,12,10,40
22.160599440208493,7.386866480069498,2.4622888266898326,12.311444133449163,9,0,0,9
48.014632120451736,19.69831061351866,16.00487737348391,12.311444133449163,15,9,30,54
16.00487737348391,10.46472751343179,5.540149860052123,0.0,12,10,0,22
30.075605970982576,14.539511164250994,7.9575119741795906,7.578582832551991,11,12,10,33
36.062686408698646,20.981306571920186,11.292088420502466,3.7892914162759954,9,11,0,20
95.22489329101577,29.76867336626422,24.456086800645274,41.00013312410627,14,15,15,44
46.831852613755025,16.138592141919467,4.168220557903595,26.52503991393197,12,5,10,27
24.711850187081428,17.29644127872991,7.415408908351517,0.0,10,2,15,27
45.55234329376191,23.39174385355341,16.00487737348391,6.155722066724581,17,10,0,27
63.96702839815508,30.121077467977887,20.96236011483881,12.883590815338385,19,13,0,32
17.240825711917278,14.460047371285457,2.780778340631819,0.0,18,11,0,29
23.39174385355341,9.84915530675933,7.386866480069498,6.155722066724581,7,0,0,7
75.90831367589561,32.925259418410164,18.99733662643256,23.985717631052886,11,6,0,17
23.379928038422893,17.6959909140089,5.683937124413993,0.0,14,0,0,14
60.76886644281814,29.61710170961318,15.994599068100978,15.157165665103982,13,4,0,17
17.23602178682883,11.695871926776706,5.540149860052123,0.0,6,0,0,6
61.57219622306865,28.47273570189783,17.942294856066837,15.157165665103982,22,16,0,38
36.31876019367503,17.11290734549434,4.432119888041698,14.773732960138997,7,0,0,7
25.238460473570786,16.62044958015637,8.618010893414414,0.0,4,0,0,4
73.7398751495207,28.97085732247982,22.079825473342197,22.689192353698676,15,16,0,31
60.85223085397621,28.059702937523745,13.429248779282128,19.363279137170338,21,15,15,51
18.467166200173747,10.46472751343179,1.8467166200173746,6.155722066724581,14,0,0,14
13.54258854679408,13.542588546794079,0.0,0.0,10,0,0,10
44.253649029292575,19.334433198544655,11.953963057205815,12.9652527735421,5,14,20,39
35.19872796578772,22.781219994651284,12.417507971136436,0.0,16,0,0,16
31.75047277697656,18.48795282001058,5.683937124413993,7.578582832551991,16,0,0,16
33.8564713669852,14.773732960138997,0.6155722066724582,18.467166200173743,7,0,0,7
52.629202321000776,27.544679517390193,18.601896416839526,6.48262638677105,14,4,0,18
26.8509189757317,15.861973868531317,7.199653690924391,3.7892914162759954,4,0,0,4
81.00950859656432,33.65339543599481,23.391335128833628,23.964778031735875,16,14,15,45
108.99888006716844,36.30919039230465,27.538196891003416,45.15149278386036,8,9,0,17
59.47292877845175,28.237799634088724,23.65654631181104,7.578582832551991,11,12,10,33
42.58298565620858,19.873295874382062,13.440428646387124,9.269261135439397,7,0,0,7
38.61287953185239,21.485282330284893,12.580447502036305,4.547149699531195,12,8,0,20
13.54258854679408,9.84915530675933,3.693433240034749,0.0,6,0,0,6
48.78333769313717,25.21394508390047,14.475093210174304,9.09429939906239,21,15,20,56
32.58790617997356,17.43074051486958,11.367874248827986,3.7892914162759954,17,11,0,28
46.39291573692702,22.59843558428388,11.056119302638026,12.738360850005112,13,10,0,23
102.31529226240748,35.2006612801668,27.149239307797153,39.965391674443524,20,16,30,66
61.89807528486838,23.89148237962015,17.54441925735786,20.462173647890374,8,0,0,8
82.43603476108427,31.526904583416282,23.967268207945672,26.941861969722325,14,11,0,25
21.0,10.0,11.0,0.0,16,10,0,26
38.71770376273035,22.959959832483385,11.123113362527276,4.634630567719698,18,13,0,31
55.433544128701534,25.717920842265183,17.173068698562812,12.542554587873546,14,7,0,21
37.7602889631903,21.845265014831114,8.33644111580719,7.578582832551991,11,0,0,11
29.40209632161376,17.815519902314517,6.951945851579547,4.634630567719698,15,9,0,24
20.31388282019112,14.158160753466538,6.155722066724581,0.0,10,1,30,41
69.22472587113467,32.030656977035754,23.224009030607288,13.970059863491613,22,16,30,68
26.4696048869157,17.23602178682883,9.233583100086872,0.0,12,6,0,18
33.05418520897688,17.759904335501883,6.025019738035607,9.269261135439397,11,0,0,11
67.7823415000781,29.210714498790352,18.47548520229749,20.096141798990253,18,14,15,47
43.96874019595678,23.576365697990106,11.123113362527276,9.269261135439397,9,2,20,31
32.90124240024214,17.606961526767133,10.659650305755305,4.634630567719698,5,0,0,5
28.316321506933075,18.467166200173743,9.84915530675933,0.0,13,0,0,13
10.988945107200387,10.988945107200387,0.0,0.0,9,0,15,24
54.83483608492993,23.641389146145936,9.55659295184806,21.636853986935936,17,12,10,39
33.56862920199377,20.591663612378618,8.342335021895456,4.634630567719698,9,0,0,9
19.082738406846204,9.233583100086872,3.693433240034749,6.155722066724581,8,6,5,19
38.999387256312545,21.947575883070567,9.47322854068999,7.578582832551991,14,10,0,24
46.74469891118068,23.42161024400193,13.470930984861162,9.85215768231759,16,16,15,47
42.221484471926445,21.36564691718781,11.586576419299245,9.269261135439397,10,5,10,25
103.21637733016867,32.40664930746848,26.37132414138463,44.438403881315544,22,16,15,53
43.36086167644622,21.76190060367304,10.231086823945187,11.367874248827986,19,14,10,43
42.26575645714245,24.077157659017676,14.399307381848782,3.7892914162759954,12,13,5,30
82.59838410704333,33.126220836400066,19.58725562762873,29.88490764301454,21,15,30,66
41.51926604813608,24.387879555152306,13.34209507670778,3.7892914162759954,13,12,10,35
39.29874127819834,26.16505722938575,13.133684048812599,0.0,15,14,10,39
37.54990460701995,16.62044958015637,8.618010893414414,12.311444133449163,11,9,0,20
9.84915530675933,9.84915530675933,0.0,0.0,11,2,30,43
46.90763844208055,23.94074316803174,15.388312441496817,7.578582832551991,17,12,10,39
37.54050759852955,14.830817816703034,4.171167510947728,18.538522270878794,14,9,0,23
28.316321506933075,16.62044958015637,11.695871926776706,0.0,15,11,5,31
52.33390375018778,21.74674343800794,14.179528479704777,16.407631832475058,17,15,30,62
41.49848210336217,23.423422889255352,13.440428646387124,4.634630567719698,18,13,0,31
16.499284821082124,11.864654253362428,4.634630567719698,0.0,7,11,5,23
35.11196118104443,20.744606421113367,9.732724192211366,4.634630567719698,10,4,5,19
19.69831061351866,12.311444133449163,1.2311444133449163,6.155722066724581,13,8,0,21
36.094502861401004,15.702128363434335,11.123113362527276,9.269261135439397,12,10,0,22
9.776371853992067,9.776371853992067,0.0,0.0,4,3,10,17
20.31388282019112,11.080299720104247,3.0778610333622907,6.155722066724581,6,7,0,13
36.0,17.0,9.0,10.0,8,0,0,8
42.63860122302122,19.465448384422732,4.634630567719698,18.538522270878794,11,14,5,30
45.55234329376191,18.467166200173743,14.773732960138997,12.311444133449163,18,13,15,46
20.31388282019112,13.542588546794079,6.771294273397039,0.0,16,10,0,26
31.39418254029537,20.313882820191118,11.080299720104247,0.0,9,9,20,38
46.90246134532334,18.816600104941973,13.255043423678337,14.830817816703034,19,15,30,64
32.0,20.0,12.0,0.0,17,12,5,34
30.16303812695045,19.69831061351866,10.46472751343179,0.0,13,5,5,23
22.0,16.0,6.0,0.0,6,1,5,12
34.47204357365766,17.23602178682883,4.924577653379665,12.311444133449163,9,4,10,23
31.39418254029537,19.082738406846204,6.155722066724581,6.155722066724581,13,7,0,20
83.97950588708092,26.232009013293492,18.816600104941976,38.930896768845464,15,11,10,36
28.931893713605536,17.23602178682883,5.540149860052123,6.155722066724581,15,0,5,20
35.08761578033012,20.313882820191118,14.773732960138997,0.0,12,8,20,40
43.658219947919555,21.411993222865007,12.976965589615155,9.269261135439397,17,11,10,38
63.053809166832565,31.223761270114206,16.67288223161438,15.157165665103982,15,16,5,36
27.807783406318187,20.855837554738642,6.951945851579547,0.0,22,16,5,43
67.01675800922683,26.880857292774248,16.962747877854095,23.17315283859849,21,15,30,66
30.778610333622908,21.545027233536036,9.233583100086872,0.0,10,0,0,10
40.16648901252555,17.43074051486958,7.578582832551991,15.157165665103982,14,13,15,42
38.00397065530152,16.22120698701894,7.878871965123487,13.903891703159093,12,0,25,37
22.160599440208493,14.158160753466538,1.8467166200173746,6.155722066724581,10,6,10,26
76.31632912379855,26.67661157058301,15.536094806731581,34.10362274648396,16,9,20,45
31.39418254029537,19.082738406846204,12.311444133449163,0.0,10,12,5,27
33.27664747622743,19.372755773068338,4.634630567719698,9.269261135439397,20,14,5,39
28.271246463090158,19.00198532765076,9.269261135439397,0.0,5,3,5,13
14.773732960138997,14.773732960138997,0.0,0.0,14,10,0,24
24.62288826689833,17.851593993501286,6.771294273397039,0.0,11,0,0,11
16.0,16.0,0.0,0.0,7,0,0,7
30.0,18.0,12.0,0.0,12,0,0,12
11.942100809445687,11.942100809445687,0.0,0.0,8,2,5,15
10.0,10.0,0.0,0.0,4,0,0,4
66.20649962517419,32.16729483276693,22.67133054357928,11.367874248827986,12,13,0,25
70.99772418791655,25.29196684798725,22.368302347553506,23.33745499237578,18,14,10,42
106.47908879735547,34.17940857480948,24.55460837746845,47.74507184507755,22,16,20,58
29.0,18.0,11.0,0.0,11,0,0,11
75.45178564247668,30.588561746950006,21.690071056928186,23.17315283859849,16,10,0,26
93.15534117789998,35.65444512724078,25.087764116803964,32.41313193385525,21,15,25,61
68.43460297794448,30.693260471835565,22.584176841004933,15.157165665103982,20,14,10,44
15.389305166811454,15.389305166811454,0.0,0.0,6,0,5,11
33.24089916031274,19.69831061351866,13.542588546794079,0.0,13,0,0,13
55.401498600521236,25.238460473570786,17.851593993501286,12.311444133449163,19,11,5,35
30.0,13.0,7.0,10.0,10,0,0,10
33.11778471897825,14.035046312132044,0.6155722066724582,18.467166200173743,14,1,20,35
11.695871926776706,11.695871926776706,0.0,0.0,8,0,0,8
21.0,8.0,3.0,10.0,14,0,10,24
18.0,18.0,0.0,0.0,3,0,0,3
13.0,6.0,7.0,0.0,15,0,0,15
36.76749461212599,23.808117968462078,8.41222694413271,4.547149699531195,11,2,30,43
37.796133489688934,19.328967289515184,6.155722066724581,12.311444133449163,22,16,15,53
17.851593993501286,12.927016340121622,4.924577653379665,0.0,10,5,0,15
45.429228852427414,20.806340585529085,6.155722066724581,18.467166200173743,15,8,0,23
36.0,17.0,9.0,10.0,12,0,0,12
8.0,8.0,0.0,0.0,10,4,0,14
50.98093624491668,22.802382393180917,14.274662148576668,13.903891703159093,17,11,5,33
41.2433378470547,14.773732960138997,8.002438686741955,18.467166200173743,13,9,0,22
81.24240796495734,28.19232813709341,21.977890214400773,31.072189613463163,18,15,30,63
20.0,15.0,0.0,5.0,18,0,0,18
31.39418254029537,19.082738406846204,12.311444133449163,0.0,17,12,10,39
8.0,8.0,0.0,0.0,15,3,10,28
63.401746166405474,27.158935126837427,13.069658200969549,23.17315283859849,17,0,0,17
13.0,13.0,0.0,0.0,5,0,0,5
10.0,10.0,0.0,0.0,14,0,0,14
16.0,16.0,0.0,0.0,16,0,0,16
24.0,13.0,11.0,0.0,10,0,0,10
29.547465920277993,20.92945502686358,8.618010893414414,0.0,19,10,0,29
4.0,4.0,0.0,0.0,11,0,0,11
11.0,11.0,0.0,0.0,14,0,0,14
29.0,17.0,12.0,0.0,14,0,0,14
10.0,10.0,0.0,0.0,18,9,0,27
11.0,11.0,0.0,0.0,4,0,0,4
9.0,9.0,0.0,0.0,16,0,0,16
